Subject	Object	Predicate
dbpA	Rifampicin	confers no resistance to antibiotic after 18 hours
fadJ	Metronidazole	confers no resistance to antibiotic after 18 hours
hslV	Vancomycin	confers no resistance to antibiotic after 18 hours
yegS	Rifampicin	confers no resistance to antibiotic after 18 hours
yjfY	Vancomycin	confers no resistance to antibiotic after 18 hours
pyrI	Ampicillin	confers no resistance to antibiotic after 18 hours
purB	Ampicillin	confers no resistance to antibiotic after 18 hours
yecC	Metronidazole	confers no resistance to antibiotic after 18 hours
tolA	Ampicillin	confers no resistance to antibiotic after 18 hours
ftnA	Sulfamethoxazole	confers no resistance to antibiotic after 18 hours
cobS	Metronidazole	confers no resistance to antibiotic after 18 hours
yehA	Vancomycin	confers no resistance to antibiotic after 18 hours
yeaM	Ampicillin	confers no resistance to antibiotic after 18 hours
paaY	Ciprofloxacin	confers no resistance to antibiotic after 18 hours
dedA	Rifampicin	confers no resistance to antibiotic after 18 hours
dgkA	Rifampicin	confers no resistance to antibiotic after 18 hours
apaH	Vancomycin	confers no resistance to antibiotic after 18 hours
citX	Gentamicin	confers no resistance to antibiotic after 18 hours
bacA	Ciprofloxacin	confers no resistance to antibiotic after 18 hours
yghD	Metronidazole	confers no resistance to antibiotic after 18 hours
argG	Vancomycin	confers no resistance to antibiotic after 18 hours
ttdA	Ciprofloxacin	confers no resistance to antibiotic after 18 hours
yqaA	Sulfamethoxazole	confers no resistance to antibiotic after 18 hours
prlC	Rifampicin	confers no resistance to antibiotic after 18 hours
tusC	Gentamicin	confers resistance to antibiotic after 18 hours
icdC	Vancomycin	confers no resistance to antibiotic after 18 hours
pflD	Rifampicin	confers no resistance to antibiotic after 18 hours
rfaD	Vancomycin	confers no resistance to antibiotic after 18 hours
rutA	Vancomycin	confers no resistance to antibiotic after 18 hours
raiA	Rifampicin	confers no resistance to antibiotic after 18 hours
yfeO	Rifampicin	confers no resistance to antibiotic after 18 hours
yfjJ	Rifampicin	confers no resistance to antibiotic after 18 hours
rsmE	Ampicillin	confers no resistance to antibiotic after 18 hours
yhgE	Vancomycin	confers no resistance to antibiotic after 18 hours
ydfG	Rifampicin	confers no resistance to antibiotic after 18 hours
icd	Ciprofloxacin	confers no resistance to antibiotic after 18 hours
yjfM	Gentamicin	confers no resistance to antibiotic after 18 hours
fepE	Rifampicin	confers no resistance to antibiotic after 18 hours
slyB	Ciprofloxacin	confers no resistance to antibiotic after 18 hours
nudL	Vancomycin	confers no resistance to antibiotic after 18 hours
rnr	Gentamicin	confers no resistance to antibiotic after 18 hours
glxK	Ciprofloxacin	confers no resistance to antibiotic after 18 hours
ulaB	Ampicillin	confers no resistance to antibiotic after 18 hours
glk	Ampicillin	confers no resistance to antibiotic after 18 hours
treF	Ciprofloxacin	confers no resistance to antibiotic after 18 hours
yiaU	Ampicillin	confers no resistance to antibiotic after 18 hours
malS	Vancomycin	confers no resistance to antibiotic after 18 hours
yjhI	Rifampicin	confers no resistance to antibiotic after 18 hours
ybiS	Sulfamethoxazole	confers no resistance to antibiotic after 18 hours
paaZ	Vancomycin	confers no resistance to antibiotic after 18 hours
trpD	Gentamicin	confers no resistance to antibiotic after 18 hours
yieK	Vancomycin	confers no resistance to antibiotic after 18 hours
cbrA	Ciprofloxacin	confers no resistance to antibiotic after 18 hours
rnt	Ampicillin	confers no resistance to antibiotic after 18 hours
caiC	Sulfamethoxazole	confers no resistance to antibiotic after 18 hours
rimM	Sulfamethoxazole	confers no resistance to antibiotic after 18 hours
eutH	Ampicillin	confers no resistance to antibiotic after 18 hours
ppdD	Metronidazole	confers no resistance to antibiotic after 18 hours
crcB	Ampicillin	confers no resistance to antibiotic after 18 hours
ycjX	Ampicillin	confers no resistance to antibiotic after 18 hours
yecM	Rifampicin	confers no resistance to antibiotic after 18 hours
cusA	Ciprofloxacin	confers no resistance to antibiotic after 18 hours
ampC	Metronidazole	confers no resistance to antibiotic after 18 hours
pgi	Sulfamethoxazole	confers no resistance to antibiotic after 18 hours
sufB	Gentamicin	confers no resistance to antibiotic after 18 hours
gntR	Vancomycin	confers no resistance to antibiotic after 18 hours
feaR	Rifampicin	confers no resistance to antibiotic after 18 hours
ompX	Rifampicin	confers no resistance to antibiotic after 18 hours
feaB	Metronidazole	confers no resistance to antibiotic after 18 hours
ttdR	Sulfamethoxazole	confers no resistance to antibiotic after 18 hours
yfaV	Ampicillin	confers no resistance to antibiotic after 18 hours
yddG	Rifampicin	confers no resistance to antibiotic after 18 hours
nhaA	Ampicillin	confers no resistance to antibiotic after 18 hours
trxA	Gentamicin	confers no resistance to antibiotic after 18 hours
rplA	Ciprofloxacin	confers no resistance to antibiotic after 18 hours
ttcA	Ciprofloxacin	confers no resistance to antibiotic after 18 hours
ygfI	Ciprofloxacin	confers no resistance to antibiotic after 18 hours
thiG	Ciprofloxacin	confers no resistance to antibiotic after 18 hours
ybjI	Gentamicin	confers no resistance to antibiotic after 18 hours
ybgE	Ampicillin	confers no resistance to antibiotic after 18 hours
yadV	Rifampicin	confers no resistance to antibiotic after 18 hours
fadJ	Rifampicin	confers no resistance to antibiotic after 18 hours
wbbK	Rifampicin	confers no resistance to antibiotic after 18 hours
mngA	Rifampicin	confers no resistance to antibiotic after 18 hours
nlpI	Sulfamethoxazole	confers no resistance to antibiotic after 18 hours
yceJ	Sulfamethoxazole	confers no resistance to antibiotic after 18 hours
wcaC	Sulfamethoxazole	confers no resistance to antibiotic after 18 hours
cpdA	Vancomycin	confers no resistance to antibiotic after 18 hours
blc	Ampicillin	confers no resistance to antibiotic after 18 hours
cvpA	Ciprofloxacin	confers no resistance to antibiotic after 18 hours
ykgC	Rifampicin	confers no resistance to antibiotic after 18 hours
yphA	Rifampicin	confers no resistance to antibiotic after 18 hours
ybhI	Ciprofloxacin	confers no resistance to antibiotic after 18 hours
ytfT	Metronidazole	confers no resistance to antibiotic after 18 hours
nrfF	Rifampicin	confers no resistance to antibiotic after 18 hours
mglB	Ciprofloxacin	confers no resistance to antibiotic after 18 hours
bisC	Ciprofloxacin	confers no resistance to antibiotic after 18 hours
tnaC	Ciprofloxacin	confers no resistance to antibiotic after 18 hours
ycfS	Sulfamethoxazole	confers no resistance to antibiotic after 18 hours
ynfD	Ampicillin	confers no resistance to antibiotic after 18 hours
yebB	Ciprofloxacin	confers no resistance to antibiotic after 18 hours
fimF	Ciprofloxacin	confers no resistance to antibiotic after 18 hours
dhaL	Metronidazole	confers no resistance to antibiotic after 18 hours
yafJ	Rifampicin	confers no resistance to antibiotic after 18 hours
bssR	Sulfamethoxazole	confers no resistance to antibiotic after 18 hours
lacY	Metronidazole	confers no resistance to antibiotic after 18 hours
ilvE	Metronidazole	confers no resistance to antibiotic after 18 hours
yjaH	Sulfamethoxazole	confers no resistance to antibiotic after 18 hours
livM	Sulfamethoxazole	confers no resistance to antibiotic after 18 hours
hrpB	Gentamicin	confers no resistance to antibiotic after 18 hours
ilvH	Sulfamethoxazole	confers no resistance to antibiotic after 18 hours
pyrI	Sulfamethoxazole	confers no resistance to antibiotic after 18 hours
cyaA	Sulfamethoxazole	confers no resistance to antibiotic after 18 hours
yeeZ	Metronidazole	confers no resistance to antibiotic after 18 hours
yncH	Sulfamethoxazole	confers no resistance to antibiotic after 18 hours
cvrA	Gentamicin	confers no resistance to antibiotic after 18 hours
nrdG	Ciprofloxacin	confers no resistance to antibiotic after 18 hours
nsrR	Ampicillin	confers no resistance to antibiotic after 18 hours
mrp	Sulfamethoxazole	confers no resistance to antibiotic after 18 hours
afuB	Gentamicin	confers no resistance to antibiotic after 18 hours
phoH	Gentamicin	confers no resistance to antibiotic after 18 hours
yafE	Metronidazole	confers no resistance to antibiotic after 18 hours
yacL	Ampicillin	confers no resistance to antibiotic after 18 hours
rarA	Ampicillin	confers no resistance to antibiotic after 18 hours
ynjE	Sulfamethoxazole	confers no resistance to antibiotic after 18 hours
fiu	Sulfamethoxazole	confers no resistance to antibiotic after 18 hours
mscK	Sulfamethoxazole	confers no resistance to antibiotic after 18 hours
ycdY	Rifampicin	confers no resistance to antibiotic after 18 hours
rpmG	Ampicillin	confers no resistance to antibiotic after 18 hours
blr	Ciprofloxacin	confers no resistance to antibiotic after 18 hours
hisH	Gentamicin	confers no resistance to antibiotic after 18 hours
waaG	Ciprofloxacin	confers no resistance to antibiotic after 18 hours
gltL	Ciprofloxacin	confers no resistance to antibiotic after 18 hours
mdtM	Gentamicin	confers no resistance to antibiotic after 18 hours
dmsD	Metronidazole	confers no resistance to antibiotic after 18 hours
yfcG	Ciprofloxacin	confers no resistance to antibiotic after 18 hours
aslB	Ampicillin	confers no resistance to antibiotic after 18 hours
gltD	Gentamicin	confers no resistance to antibiotic after 18 hours
yihD	Sulfamethoxazole	confers no resistance to antibiotic after 18 hours
zinT	Ciprofloxacin	confers no resistance to antibiotic after 18 hours
aslB	Ciprofloxacin	confers no resistance to antibiotic after 18 hours
tgt	Vancomycin	confers no resistance to antibiotic after 18 hours
yaiO	Ampicillin	confers no resistance to antibiotic after 18 hours
mglB	Metronidazole	confers no resistance to antibiotic after 18 hours
glgX	Ciprofloxacin	confers no resistance to antibiotic after 18 hours
ynfF	Vancomycin	confers no resistance to antibiotic after 18 hours
ychJ	Rifampicin	confers resistance to antibiotic after 18 hours
ymfE	Ciprofloxacin	confers no resistance to antibiotic after 18 hours
yjdM	Gentamicin	confers no resistance to antibiotic after 18 hours
tsx	Metronidazole	confers no resistance to antibiotic after 18 hours
fecD	Ampicillin	confers no resistance to antibiotic after 18 hours
hycG	Rifampicin	confers no resistance to antibiotic after 18 hours
ydgA	Ciprofloxacin	confers no resistance to antibiotic after 18 hours
tgt	Sulfamethoxazole	confers no resistance to antibiotic after 18 hours
uhpB	Vancomycin	confers no resistance to antibiotic after 18 hours
purL	Ciprofloxacin	confers no resistance to antibiotic after 18 hours
crl	Ampicillin	confers no resistance to antibiotic after 18 hours
yebE	Vancomycin	confers no resistance to antibiotic after 18 hours
yghF	Ciprofloxacin	confers no resistance to antibiotic after 18 hours
ilvC	Ampicillin	confers no resistance to antibiotic after 18 hours
cspG	Metronidazole	confers no resistance to antibiotic after 18 hours
yneH	Sulfamethoxazole	confers no resistance to antibiotic after 18 hours
nsrR	Rifampicin	confers no resistance to antibiotic after 18 hours
ydfV	Rifampicin	confers no resistance to antibiotic after 18 hours
rmf	Rifampicin	confers no resistance to antibiotic after 18 hours
amiA	Ciprofloxacin	confers no resistance to antibiotic after 18 hours
yecN	Vancomycin	confers no resistance to antibiotic after 18 hours
rseA	Gentamicin	confers no resistance to antibiotic after 18 hours
yohF	Gentamicin	confers no resistance to antibiotic after 18 hours
mdoB	Rifampicin	confers no resistance to antibiotic after 18 hours
ysgA	Ciprofloxacin	confers no resistance to antibiotic after 18 hours
fbaB	Sulfamethoxazole	confers no resistance to antibiotic after 18 hours
fdoH	Ciprofloxacin	confers no resistance to antibiotic after 18 hours
rhoL	Rifampicin	confers no resistance to antibiotic after 18 hours
ybdL	Vancomycin	confers no resistance to antibiotic after 18 hours
msrA	Ciprofloxacin	confers no resistance to antibiotic after 18 hours
livK	Sulfamethoxazole	confers no resistance to antibiotic after 18 hours
cmoB	Gentamicin	confers no resistance to antibiotic after 18 hours
rlmF	Rifampicin	confers no resistance to antibiotic after 18 hours
lomR	Sulfamethoxazole	confers no resistance to antibiotic after 18 hours
tnaA	Sulfamethoxazole	confers no resistance to antibiotic after 18 hours
ygeG	Sulfamethoxazole	confers no resistance to antibiotic after 18 hours
edd	Ampicillin	confers no resistance to antibiotic after 18 hours
tatB	Metronidazole	confers no resistance to antibiotic after 18 hours
uxuA	Ampicillin	confers no resistance to antibiotic after 18 hours
lpoA	Ciprofloxacin	confers no resistance to antibiotic after 18 hours
aspA	Ciprofloxacin	confers no resistance to antibiotic after 18 hours
yebV	Vancomycin	confers no resistance to antibiotic after 18 hours
yaiI	Vancomycin	confers no resistance to antibiotic after 18 hours
ybfE	Vancomycin	confers no resistance to antibiotic after 18 hours
pflB	Sulfamethoxazole	confers no resistance to antibiotic after 18 hours
yecD	Rifampicin	confers no resistance to antibiotic after 18 hours
fadH	Vancomycin	confers no resistance to antibiotic after 18 hours
mngB	Gentamicin	confers no resistance to antibiotic after 18 hours
eutR	Vancomycin	confers no resistance to antibiotic after 18 hours
tamA	Metronidazole	confers no resistance to antibiotic after 18 hours
nfo	Sulfamethoxazole	confers no resistance to antibiotic after 18 hours
oxyR	Ampicillin	confers no resistance to antibiotic after 18 hours
rcsB	Rifampicin	confers no resistance to antibiotic after 18 hours
fryC	Ampicillin	confers no resistance to antibiotic after 18 hours
potE	Vancomycin	confers no resistance to antibiotic after 18 hours
ycgN	Rifampicin	confers no resistance to antibiotic after 18 hours
yghA	Ciprofloxacin	confers no resistance to antibiotic after 18 hours
yejF	Vancomycin	confers no resistance to antibiotic after 18 hours
caiE	Metronidazole	confers no resistance to antibiotic after 18 hours
yjeT	Gentamicin	confers no resistance to antibiotic after 18 hours
paaX	Ampicillin	confers no resistance to antibiotic after 18 hours
glgC	Ampicillin	confers no resistance to antibiotic after 18 hours
ymgA	Ampicillin	confers no resistance to antibiotic after 18 hours
frmB	Metronidazole	confers no resistance to antibiotic after 18 hours
nudG	Ampicillin	confers no resistance to antibiotic after 18 hours
rspA	Ciprofloxacin	confers no resistance to antibiotic after 18 hours
cadB	Ciprofloxacin	confers no resistance to antibiotic after 18 hours
trpR	Sulfamethoxazole	confers no resistance to antibiotic after 18 hours
yhjX	Ciprofloxacin	confers no resistance to antibiotic after 18 hours
ptsA	Ampicillin	confers no resistance to antibiotic after 18 hours
agp	Sulfamethoxazole	confers no resistance to antibiotic after 18 hours
cstA	Rifampicin	confers no resistance to antibiotic after 18 hours
aslA	Metronidazole	confers no resistance to antibiotic after 18 hours
ydbJ	Ampicillin	confers no resistance to antibiotic after 18 hours
hybC	Rifampicin	confers no resistance to antibiotic after 18 hours
smrB	Gentamicin	confers no resistance to antibiotic after 18 hours
yagP	Gentamicin	confers no resistance to antibiotic after 18 hours
frlC	Ampicillin	confers no resistance to antibiotic after 18 hours
ygaX	Sulfamethoxazole	confers no resistance to antibiotic after 18 hours
yegV	Metronidazole	confers no resistance to antibiotic after 18 hours
yqaC	Rifampicin	confers no resistance to antibiotic after 18 hours
uup	Gentamicin	confers no resistance to antibiotic after 18 hours
pepQ	Sulfamethoxazole	confers no resistance to antibiotic after 18 hours
hcaT	Vancomycin	confers no resistance to antibiotic after 18 hours
pbl	Ciprofloxacin	confers no resistance to antibiotic after 18 hours
uvrA	Ampicillin	confers no resistance to antibiotic after 18 hours
nlpC	Gentamicin	confers no resistance to antibiotic after 18 hours
dicB	Ciprofloxacin	confers no resistance to antibiotic after 18 hours
purN	Rifampicin	confers no resistance to antibiotic after 18 hours
dinJ	Metronidazole	confers no resistance to antibiotic after 18 hours
fliY	Vancomycin	confers no resistance to antibiotic after 18 hours
rffC	Metronidazole	confers no resistance to antibiotic after 18 hours
upp	Ciprofloxacin	confers no resistance to antibiotic after 18 hours
dgt	Vancomycin	confers no resistance to antibiotic after 18 hours
ynfB	Ampicillin	confers no resistance to antibiotic after 18 hours
xanQ	Rifampicin	confers no resistance to antibiotic after 18 hours
gsiB	Ciprofloxacin	confers no resistance to antibiotic after 18 hours
kbl	Metronidazole	confers no resistance to antibiotic after 18 hours
ybbP	Vancomycin	confers no resistance to antibiotic after 18 hours
phoA	Ciprofloxacin	confers no resistance to antibiotic after 18 hours
yebY	Rifampicin	confers no resistance to antibiotic after 18 hours
uhpB	Metronidazole	confers no resistance to antibiotic after 18 hours
yhaO	Ampicillin	confers no resistance to antibiotic after 18 hours
lepA	Sulfamethoxazole	confers no resistance to antibiotic after 18 hours
gltB	Vancomycin	confers no resistance to antibiotic after 18 hours
ycfK	Gentamicin	confers no resistance to antibiotic after 18 hours
phnL	Rifampicin	confers no resistance to antibiotic after 18 hours
yidF	Vancomycin	confers no resistance to antibiotic after 18 hours
yiaT	Ciprofloxacin	confers no resistance to antibiotic after 18 hours
tnaB	Ciprofloxacin	confers no resistance to antibiotic after 18 hours
djlA	Ampicillin	confers no resistance to antibiotic after 18 hours
yaaA	Metronidazole	confers no resistance to antibiotic after 18 hours
asnC	Ampicillin	confers no resistance to antibiotic after 18 hours
ppsR	Ciprofloxacin	confers no resistance to antibiotic after 18 hours
aceE	Ciprofloxacin	confers no resistance to antibiotic after 18 hours
hflD	Rifampicin	confers no resistance to antibiotic after 18 hours
yehD	Sulfamethoxazole	confers no resistance to antibiotic after 18 hours
ybhB	Ciprofloxacin	confers no resistance to antibiotic after 18 hours
yaiA	Ciprofloxacin	confers no resistance to antibiotic after 18 hours
frwB	Vancomycin	confers no resistance to antibiotic after 18 hours
ygaC	Ciprofloxacin	confers no resistance to antibiotic after 18 hours
npr	Ciprofloxacin	confers no resistance to antibiotic after 18 hours
rpoZ	Vancomycin	confers no resistance to antibiotic after 18 hours
yjfN	Ampicillin	confers no resistance to antibiotic after 18 hours
ykfG	Sulfamethoxazole	confers no resistance to antibiotic after 18 hours
yaiO	Gentamicin	confers no resistance to antibiotic after 18 hours
ydhJ	Ciprofloxacin	confers no resistance to antibiotic after 18 hours
iraP	Sulfamethoxazole	confers no resistance to antibiotic after 18 hours
cstA	Ciprofloxacin	confers no resistance to antibiotic after 18 hours
ada	Sulfamethoxazole	confers no resistance to antibiotic after 18 hours
yigZ	Ciprofloxacin	confers no resistance to antibiotic after 18 hours
rhsD	Vancomycin	confers no resistance to antibiotic after 18 hours
rhsE	Metronidazole	confers no resistance to antibiotic after 18 hours
ycgB	Sulfamethoxazole	confers no resistance to antibiotic after 18 hours
prfB	Rifampicin	confers no resistance to antibiotic after 18 hours
ilvD	Vancomycin	confers no resistance to antibiotic after 18 hours
yhdY	Ciprofloxacin	confers no resistance to antibiotic after 18 hours
glxR	Vancomycin	confers no resistance to antibiotic after 18 hours
yifE	Gentamicin	confers no resistance to antibiotic after 18 hours
chaC	Rifampicin	confers no resistance to antibiotic after 18 hours
yadK	Gentamicin	confers no resistance to antibiotic after 18 hours
ykgM	Gentamicin	confers no resistance to antibiotic after 18 hours
ydcD	Metronidazole	confers no resistance to antibiotic after 18 hours
glrR	Ampicillin	confers no resistance to antibiotic after 18 hours
matP	Vancomycin	confers no resistance to antibiotic after 18 hours
ykgD	Sulfamethoxazole	confers no resistance to antibiotic after 18 hours
trpE	Metronidazole	confers no resistance to antibiotic after 18 hours
ybjO	Sulfamethoxazole	confers no resistance to antibiotic after 18 hours
pheP	Sulfamethoxazole	confers no resistance to antibiotic after 18 hours
lrp	Metronidazole	confers no resistance to antibiotic after 18 hours
yfjR	Ampicillin	confers no resistance to antibiotic after 18 hours
cusB	Vancomycin	confers no resistance to antibiotic after 18 hours
mdtN	Ciprofloxacin	confers no resistance to antibiotic after 18 hours
ygcW	Vancomycin	confers no resistance to antibiotic after 18 hours
yrdB	Sulfamethoxazole	confers no resistance to antibiotic after 18 hours
bssS	Ciprofloxacin	confers no resistance to antibiotic after 18 hours
solA	Sulfamethoxazole	confers no resistance to antibiotic after 18 hours
mltB	Sulfamethoxazole	confers no resistance to antibiotic after 18 hours
yigZ	Gentamicin	confers no resistance to antibiotic after 18 hours
ydeR	Ciprofloxacin	confers no resistance to antibiotic after 18 hours
rffG	Metronidazole	confers no resistance to antibiotic after 18 hours
ydhL	Vancomycin	confers no resistance to antibiotic after 18 hours
mutT	Sulfamethoxazole	confers no resistance to antibiotic after 18 hours
ycbU	Rifampicin	confers no resistance to antibiotic after 18 hours
tamB	Ampicillin	confers no resistance to antibiotic after 18 hours
ybdO	Rifampicin	confers no resistance to antibiotic after 18 hours
yehL	Ampicillin	confers no resistance to antibiotic after 18 hours
ybeX	Ampicillin	confers no resistance to antibiotic after 18 hours
yafU	Sulfamethoxazole	confers no resistance to antibiotic after 18 hours
yhhW	Metronidazole	confers no resistance to antibiotic after 18 hours
ycbK	Ciprofloxacin	confers no resistance to antibiotic after 18 hours
qseB	Ciprofloxacin	confers no resistance to antibiotic after 18 hours
yaaA	Gentamicin	confers no resistance to antibiotic after 18 hours
waaY	Metronidazole	confers no resistance to antibiotic after 18 hours
yebT	Gentamicin	confers no resistance to antibiotic after 18 hours
prmA	Ampicillin	confers no resistance to antibiotic after 18 hours
sdhB	Vancomycin	confers no resistance to antibiotic after 18 hours
holE	Vancomycin	confers no resistance to antibiotic after 18 hours
ypdE	Ampicillin	confers no resistance to antibiotic after 18 hours
yzfA	Sulfamethoxazole	confers no resistance to antibiotic after 18 hours
yobB	Ampicillin	confers no resistance to antibiotic after 18 hours
htpX	Sulfamethoxazole	confers no resistance to antibiotic after 18 hours
mutL	Metronidazole	confers no resistance to antibiotic after 18 hours
yddG	Metronidazole	confers no resistance to antibiotic after 18 hours
ykgJ	Ciprofloxacin	confers no resistance to antibiotic after 18 hours
yddJ	Ciprofloxacin	confers no resistance to antibiotic after 18 hours
trmJ	Ciprofloxacin	confers no resistance to antibiotic after 18 hours
ssuC	Gentamicin	confers no resistance to antibiotic after 18 hours
yiiR	Vancomycin	confers no resistance to antibiotic after 18 hours
pnuC	Vancomycin	confers no resistance to antibiotic after 18 hours
nrfF	Metronidazole	confers no resistance to antibiotic after 18 hours
carB	Ampicillin	confers no resistance to antibiotic after 18 hours
frmB	Ciprofloxacin	confers no resistance to antibiotic after 18 hours
rsmA	Sulfamethoxazole	confers no resistance to antibiotic after 18 hours
qor	Ampicillin	confers no resistance to antibiotic after 18 hours
exbB	Vancomycin	confers no resistance to antibiotic after 18 hours
fdoI	Gentamicin	confers no resistance to antibiotic after 18 hours
ybhD	Vancomycin	confers no resistance to antibiotic after 18 hours
yjcO	Ciprofloxacin	confers no resistance to antibiotic after 18 hours
aceB	Ampicillin	confers no resistance to antibiotic after 18 hours
napH	Ampicillin	confers no resistance to antibiotic after 18 hours
purN	Ampicillin	confers no resistance to antibiotic after 18 hours
yfcL	Vancomycin	confers no resistance to antibiotic after 18 hours
dsdA	Metronidazole	confers no resistance to antibiotic after 18 hours
yeaK	Rifampicin	confers no resistance to antibiotic after 18 hours
evgA	Gentamicin	confers no resistance to antibiotic after 18 hours
yrhA	Sulfamethoxazole	confers no resistance to antibiotic after 18 hours
yfbR	Sulfamethoxazole	confers no resistance to antibiotic after 18 hours
agaB	Sulfamethoxazole	confers no resistance to antibiotic after 18 hours
dedD	Metronidazole	confers resistance to antibiotic after 18 hours
yohO	Ampicillin	confers no resistance to antibiotic after 18 hours
ybhP	Metronidazole	confers no resistance to antibiotic after 18 hours
nmpC	Ampicillin	confers no resistance to antibiotic after 18 hours
prpC	Ampicillin	confers no resistance to antibiotic after 18 hours
yafY	Sulfamethoxazole	confers no resistance to antibiotic after 18 hours
rluA	Gentamicin	confers no resistance to antibiotic after 18 hours
mtn	Vancomycin	confers no resistance to antibiotic after 18 hours
ybcK	Sulfamethoxazole	confers no resistance to antibiotic after 18 hours
yobD	Sulfamethoxazole	confers no resistance to antibiotic after 18 hours
yadI	Sulfamethoxazole	confers no resistance to antibiotic after 18 hours
pqqL	Sulfamethoxazole	confers no resistance to antibiotic after 18 hours
rhaT	Gentamicin	confers no resistance to antibiotic after 18 hours
fimE	Metronidazole	confers no resistance to antibiotic after 18 hours
yhjJ	Gentamicin	confers no resistance to antibiotic after 18 hours
mdtF	Ampicillin	confers no resistance to antibiotic after 18 hours
paaC	Sulfamethoxazole	confers no resistance to antibiotic after 18 hours
yfdE	Gentamicin	confers no resistance to antibiotic after 18 hours
ydcM	Sulfamethoxazole	confers no resistance to antibiotic after 18 hours
yjhE	Gentamicin	confers no resistance to antibiotic after 18 hours
mraZ	Ciprofloxacin	confers no resistance to antibiotic after 18 hours
yhfK	Ciprofloxacin	confers no resistance to antibiotic after 18 hours
lysC	Gentamicin	confers no resistance to antibiotic after 18 hours
yejA	Metronidazole	confers no resistance to antibiotic after 18 hours
dcuR	Rifampicin	confers no resistance to antibiotic after 18 hours
trpA	Vancomycin	confers no resistance to antibiotic after 18 hours
yfgO	Ampicillin	confers no resistance to antibiotic after 18 hours
ycfK	Sulfamethoxazole	confers no resistance to antibiotic after 18 hours
mgtA	Sulfamethoxazole	confers no resistance to antibiotic after 18 hours
yceI	Ciprofloxacin	confers no resistance to antibiotic after 18 hours
gltL	Gentamicin	confers no resistance to antibiotic after 18 hours
fklB	Metronidazole	confers no resistance to antibiotic after 18 hours
zwf	Gentamicin	confers no resistance to antibiotic after 18 hours
rpmF	Ciprofloxacin	confers no resistance to antibiotic after 18 hours
ppiD	Rifampicin	confers no resistance to antibiotic after 18 hours
ybaY	Sulfamethoxazole	confers no resistance to antibiotic after 18 hours
lpxP	Ampicillin	confers no resistance to antibiotic after 18 hours
grxD	Ampicillin	confers no resistance to antibiotic after 18 hours
yaeI	Sulfamethoxazole	confers no resistance to antibiotic after 18 hours
sapD	Sulfamethoxazole	confers no resistance to antibiotic after 18 hours
yaaJ	Gentamicin	confers no resistance to antibiotic after 18 hours
yggR	Ampicillin	confers no resistance to antibiotic after 18 hours
eutS	Gentamicin	confers no resistance to antibiotic after 18 hours
ygaV	Metronidazole	confers no resistance to antibiotic after 18 hours
yoaF	Ampicillin	confers no resistance to antibiotic after 18 hours
modC	Sulfamethoxazole	confers no resistance to antibiotic after 18 hours
yiaM	Vancomycin	confers no resistance to antibiotic after 18 hours
yifK	Gentamicin	confers no resistance to antibiotic after 18 hours
ygeH	Vancomycin	confers no resistance to antibiotic after 18 hours
hyfA	Metronidazole	confers no resistance to antibiotic after 18 hours
prlC	Vancomycin	confers no resistance to antibiotic after 18 hours
tsgA	Rifampicin	confers no resistance to antibiotic after 18 hours
yciH	Rifampicin	confers no resistance to antibiotic after 18 hours
yjcD	Metronidazole	confers no resistance to antibiotic after 18 hours
dmlR	Metronidazole	confers no resistance to antibiotic after 18 hours
rapZ	Vancomycin	confers no resistance to antibiotic after 18 hours
idnD	Vancomycin	confers no resistance to antibiotic after 18 hours
yfeO	Ampicillin	confers no resistance to antibiotic after 18 hours
djlA	Rifampicin	confers no resistance to antibiotic after 18 hours
ybaQ	Ciprofloxacin	confers no resistance to antibiotic after 18 hours
glpB	Vancomycin	confers no resistance to antibiotic after 18 hours
napA	Rifampicin	confers no resistance to antibiotic after 18 hours
mcbA	Rifampicin	confers no resistance to antibiotic after 18 hours
ackA	Metronidazole	confers no resistance to antibiotic after 18 hours
rhlE	Rifampicin	confers no resistance to antibiotic after 18 hours
yahA	Ciprofloxacin	confers no resistance to antibiotic after 18 hours
yfeR	Metronidazole	confers no resistance to antibiotic after 18 hours
acpH	Gentamicin	confers no resistance to antibiotic after 18 hours
cho	Rifampicin	confers no resistance to antibiotic after 18 hours
cmoA	Ciprofloxacin	confers no resistance to antibiotic after 18 hours
ybfQ	Ciprofloxacin	confers no resistance to antibiotic after 18 hours
cysE	Sulfamethoxazole	confers no resistance to antibiotic after 18 hours
ycgX	Ampicillin	confers no resistance to antibiotic after 18 hours
ybiO	Ampicillin	confers no resistance to antibiotic after 18 hours
ygjK	Ampicillin	confers no resistance to antibiotic after 18 hours
zitB	Ciprofloxacin	confers no resistance to antibiotic after 18 hours
rsxD	Metronidazole	confers no resistance to antibiotic after 18 hours
yiaD	Rifampicin	confers no resistance to antibiotic after 18 hours
evgA	Ciprofloxacin	confers no resistance to antibiotic after 18 hours
ppiD	Sulfamethoxazole	confers no resistance to antibiotic after 18 hours
yfdV	Metronidazole	confers no resistance to antibiotic after 18 hours
glnG	Vancomycin	confers no resistance to antibiotic after 18 hours
avtA	Vancomycin	confers no resistance to antibiotic after 18 hours
ycfL	Metronidazole	confers no resistance to antibiotic after 18 hours
yggL	Ciprofloxacin	confers no resistance to antibiotic after 18 hours
ecpA	Vancomycin	confers no resistance to antibiotic after 18 hours
rem	Ciprofloxacin	confers no resistance to antibiotic after 18 hours
tusC	Metronidazole	confers no resistance to antibiotic after 18 hours
emrE	Ampicillin	confers no resistance to antibiotic after 18 hours
yhdT	Ampicillin	confers no resistance to antibiotic after 18 hours
ybhL	Vancomycin	confers no resistance to antibiotic after 18 hours
molR	Ampicillin	confers no resistance to antibiotic after 18 hours
artI	Sulfamethoxazole	confers no resistance to antibiotic after 18 hours
yehM	Rifampicin	confers no resistance to antibiotic after 18 hours
mlaF	Metronidazole	confers no resistance to antibiotic after 18 hours
yfaY	Vancomycin	confers no resistance to antibiotic after 18 hours
frmR	Rifampicin	confers no resistance to antibiotic after 18 hours
ybiB	Vancomycin	confers no resistance to antibiotic after 18 hours
ynfP	Rifampicin	confers no resistance to antibiotic after 18 hours
uacT	Gentamicin	confers no resistance to antibiotic after 18 hours
yjbI	Metronidazole	confers no resistance to antibiotic after 18 hours
lomR	Rifampicin	confers no resistance to antibiotic after 18 hours
glxR	Gentamicin	confers no resistance to antibiotic after 18 hours
cpdB	Rifampicin	confers no resistance to antibiotic after 18 hours
gluQ	Ciprofloxacin	confers no resistance to antibiotic after 18 hours
kdpC	Metronidazole	confers no resistance to antibiotic after 18 hours
dicB	Metronidazole	confers no resistance to antibiotic after 18 hours
fklB	Vancomycin	confers no resistance to antibiotic after 18 hours
fadA	Gentamicin	confers no resistance to antibiotic after 18 hours
frlB	Ampicillin	confers no resistance to antibiotic after 18 hours
phoE	Ciprofloxacin	confers no resistance to antibiotic after 18 hours
mipA	Ampicillin	confers no resistance to antibiotic after 18 hours
tauB	Ciprofloxacin	confers no resistance to antibiotic after 18 hours
focA	Ampicillin	confers no resistance to antibiotic after 18 hours
fliC	Vancomycin	confers no resistance to antibiotic after 18 hours
ydhL	Metronidazole	confers no resistance to antibiotic after 18 hours
gntT	Sulfamethoxazole	confers no resistance to antibiotic after 18 hours
yegW	Sulfamethoxazole	confers no resistance to antibiotic after 18 hours
elaB	Ciprofloxacin	confers no resistance to antibiotic after 18 hours
yhbP	Rifampicin	confers no resistance to antibiotic after 18 hours
ybfC	Sulfamethoxazole	confers no resistance to antibiotic after 18 hours
waaI	Sulfamethoxazole	confers no resistance to antibiotic after 18 hours
fliL	Gentamicin	confers no resistance to antibiotic after 18 hours
hybE	Ampicillin	confers no resistance to antibiotic after 18 hours
agaC	Sulfamethoxazole	confers no resistance to antibiotic after 18 hours
pyrL	Rifampicin	confers no resistance to antibiotic after 18 hours
rimK	Ciprofloxacin	confers resistance to antibiotic after 18 hours
yqeC	Rifampicin	confers no resistance to antibiotic after 18 hours
aas	Ciprofloxacin	confers no resistance to antibiotic after 18 hours
bamE	Vancomycin	confers resistance to antibiotic after 18 hours
citX	Metronidazole	confers no resistance to antibiotic after 18 hours
citE	Metronidazole	confers no resistance to antibiotic after 18 hours
ybiH	Rifampicin	confers no resistance to antibiotic after 18 hours
recJ	Ciprofloxacin	confers no resistance to antibiotic after 18 hours
ynfD	Ciprofloxacin	confers no resistance to antibiotic after 18 hours
fixX	Gentamicin	confers no resistance to antibiotic after 18 hours
htrE	Metronidazole	confers no resistance to antibiotic after 18 hours
yeaE	Ampicillin	confers no resistance to antibiotic after 18 hours
yggT	Ampicillin	confers no resistance to antibiotic after 18 hours
folX	Ampicillin	confers no resistance to antibiotic after 18 hours
xylH	Sulfamethoxazole	confers no resistance to antibiotic after 18 hours
hisI	Ciprofloxacin	confers no resistance to antibiotic after 18 hours
lysC	Sulfamethoxazole	confers no resistance to antibiotic after 18 hours
yjgR	Gentamicin	confers no resistance to antibiotic after 18 hours
fdnH	Gentamicin	confers no resistance to antibiotic after 18 hours
hycH	Rifampicin	confers no resistance to antibiotic after 18 hours
pflC	Metronidazole	confers no resistance to antibiotic after 18 hours
ruvC	Ampicillin	confers no resistance to antibiotic after 18 hours
frdA	Rifampicin	confers no resistance to antibiotic after 18 hours
eutM	Rifampicin	confers no resistance to antibiotic after 18 hours
malS	Rifampicin	confers no resistance to antibiotic after 18 hours
yoaH	Rifampicin	confers no resistance to antibiotic after 18 hours
fimE	Ampicillin	confers no resistance to antibiotic after 18 hours
ybgP	Ciprofloxacin	confers no resistance to antibiotic after 18 hours
pgpA	Ciprofloxacin	confers no resistance to antibiotic after 18 hours
rpmE	Vancomycin	confers no resistance to antibiotic after 18 hours
ydcN	Vancomycin	confers no resistance to antibiotic after 18 hours
emrE	Ciprofloxacin	confers no resistance to antibiotic after 18 hours
hokB	Ampicillin	confers no resistance to antibiotic after 18 hours
mutY	Ciprofloxacin	confers no resistance to antibiotic after 18 hours
yebE	Gentamicin	confers no resistance to antibiotic after 18 hours
nudE	Metronidazole	confers no resistance to antibiotic after 18 hours
yggN	Metronidazole	confers no resistance to antibiotic after 18 hours
trmH	Rifampicin	confers no resistance to antibiotic after 18 hours
selB	Metronidazole	confers no resistance to antibiotic after 18 hours
ppsR	Vancomycin	confers no resistance to antibiotic after 18 hours
yliE	Gentamicin	confers no resistance to antibiotic after 18 hours
waaZ	Ciprofloxacin	confers no resistance to antibiotic after 18 hours
yegH	Ciprofloxacin	confers no resistance to antibiotic after 18 hours
yfeC	Vancomycin	confers no resistance to antibiotic after 18 hours
ycaR	Vancomycin	confers no resistance to antibiotic after 18 hours
feoC	Ciprofloxacin	confers no resistance to antibiotic after 18 hours
recG	Ampicillin	confers no resistance to antibiotic after 18 hours
yacC	Ciprofloxacin	confers no resistance to antibiotic after 18 hours
yfaD	Gentamicin	confers no resistance to antibiotic after 18 hours
mdtF	Ciprofloxacin	confers no resistance to antibiotic after 18 hours
recR	Metronidazole	confers no resistance to antibiotic after 18 hours
bamB	Ciprofloxacin	confers no resistance to antibiotic after 18 hours
yijO	Ciprofloxacin	confers no resistance to antibiotic after 18 hours
yecM	Vancomycin	confers no resistance to antibiotic after 18 hours
aroD	Sulfamethoxazole	confers no resistance to antibiotic after 18 hours
ynjH	Rifampicin	confers no resistance to antibiotic after 18 hours
yejK	Ciprofloxacin	confers no resistance to antibiotic after 18 hours
hmp	Vancomycin	confers no resistance to antibiotic after 18 hours
ymfN	Vancomycin	confers no resistance to antibiotic after 18 hours
fdnG	Metronidazole	confers no resistance to antibiotic after 18 hours
ascG	Vancomycin	confers no resistance to antibiotic after 18 hours
narU	Metronidazole	confers no resistance to antibiotic after 18 hours
allA	Ciprofloxacin	confers no resistance to antibiotic after 18 hours
iraM	Ciprofloxacin	confers no resistance to antibiotic after 18 hours
zntA	Sulfamethoxazole	confers no resistance to antibiotic after 18 hours
wzb	Vancomycin	confers no resistance to antibiotic after 18 hours
dpiB	Sulfamethoxazole	confers no resistance to antibiotic after 18 hours
glnL	Metronidazole	confers no resistance to antibiotic after 18 hours
pcnB	Ampicillin	confers no resistance to antibiotic after 18 hours
srlR	Ampicillin	confers no resistance to antibiotic after 18 hours
gfcA	Vancomycin	confers no resistance to antibiotic after 18 hours
gatR_1	Sulfamethoxazole	confers no resistance to antibiotic after 18 hours
php	Ampicillin	confers no resistance to antibiotic after 18 hours
astD	Gentamicin	confers no resistance to antibiotic after 18 hours
hspQ	Ciprofloxacin	confers no resistance to antibiotic after 18 hours
mdoC	Ciprofloxacin	confers no resistance to antibiotic after 18 hours
ybiC	Metronidazole	confers no resistance to antibiotic after 18 hours
maa	Sulfamethoxazole	confers no resistance to antibiotic after 18 hours
racC	Ciprofloxacin	confers no resistance to antibiotic after 18 hours
ygfB	Ciprofloxacin	confers no resistance to antibiotic after 18 hours
ygjP	Metronidazole	confers no resistance to antibiotic after 18 hours
trpR	Ampicillin	confers no resistance to antibiotic after 18 hours
yiiR	Rifampicin	confers no resistance to antibiotic after 18 hours
rraA	Rifampicin	confers no resistance to antibiotic after 18 hours
cedA	Rifampicin	confers resistance to antibiotic after 18 hours
yrhB	Ampicillin	confers no resistance to antibiotic after 18 hours
dpiA	Vancomycin	confers no resistance to antibiotic after 18 hours
yzfA	Metronidazole	confers no resistance to antibiotic after 18 hours
ycjD	Vancomycin	confers no resistance to antibiotic after 18 hours
fucK	Ampicillin	confers no resistance to antibiotic after 18 hours
ykgD	Gentamicin	confers no resistance to antibiotic after 18 hours
rzpQ	Gentamicin	confers no resistance to antibiotic after 18 hours
puuC	Vancomycin	confers no resistance to antibiotic after 18 hours
pgrR	Metronidazole	confers no resistance to antibiotic after 18 hours
yfaA	Ampicillin	confers no resistance to antibiotic after 18 hours
envR	Sulfamethoxazole	confers no resistance to antibiotic after 18 hours
amyA	Ampicillin	confers no resistance to antibiotic after 18 hours
racC	Rifampicin	confers no resistance to antibiotic after 18 hours
ybbB	Vancomycin	confers no resistance to antibiotic after 18 hours
ydeM	Ampicillin	confers no resistance to antibiotic after 18 hours
eda	Rifampicin	confers no resistance to antibiotic after 18 hours
pmrD	Metronidazole	confers no resistance to antibiotic after 18 hours
ybbL	Ciprofloxacin	confers no resistance to antibiotic after 18 hours
ybjL	Ciprofloxacin	confers no resistance to antibiotic after 18 hours
gntP	Sulfamethoxazole	confers no resistance to antibiotic after 18 hours
mmuM	Ampicillin	confers no resistance to antibiotic after 18 hours
rodZ	Sulfamethoxazole	confers no resistance to antibiotic after 18 hours
endA	Ciprofloxacin	confers no resistance to antibiotic after 18 hours
mlaD	Ampicillin	confers no resistance to antibiotic after 18 hours
nrdR	Ciprofloxacin	confers no resistance to antibiotic after 18 hours
nuoF	Ampicillin	confers no resistance to antibiotic after 18 hours
hybD	Ciprofloxacin	confers no resistance to antibiotic after 18 hours
phnF	Vancomycin	confers no resistance to antibiotic after 18 hours
mhpR	Sulfamethoxazole	confers no resistance to antibiotic after 18 hours
pgaA	Rifampicin	confers no resistance to antibiotic after 18 hours
ydeI	Vancomycin	confers no resistance to antibiotic after 18 hours
yeeE	Sulfamethoxazole	confers no resistance to antibiotic after 18 hours
yahI	Gentamicin	confers no resistance to antibiotic after 18 hours
ybdR	Ampicillin	confers no resistance to antibiotic after 18 hours
gstA	Gentamicin	confers no resistance to antibiotic after 18 hours
puuA	Gentamicin	confers no resistance to antibiotic after 18 hours
ydfA	Rifampicin	confers no resistance to antibiotic after 18 hours
yagK	Sulfamethoxazole	confers no resistance to antibiotic after 18 hours
caiA	Ampicillin	confers no resistance to antibiotic after 18 hours
yobA	Gentamicin	confers no resistance to antibiotic after 18 hours
yigB	Metronidazole	confers no resistance to antibiotic after 18 hours
ygiF	Ciprofloxacin	confers no resistance to antibiotic after 18 hours
napG	Rifampicin	confers no resistance to antibiotic after 18 hours
ydjA	Metronidazole	confers no resistance to antibiotic after 18 hours
yibG	Rifampicin	confers no resistance to antibiotic after 18 hours
tldD	Ampicillin	confers no resistance to antibiotic after 18 hours
recE	Sulfamethoxazole	confers no resistance to antibiotic after 18 hours
yiiS	Ciprofloxacin	confers no resistance to antibiotic after 18 hours
yidQ	Ampicillin	confers no resistance to antibiotic after 18 hours
cysE	Rifampicin	confers no resistance to antibiotic after 18 hours
yaeH	Sulfamethoxazole	confers no resistance to antibiotic after 18 hours
ratA	Sulfamethoxazole	confers no resistance to antibiotic after 18 hours
fliQ	Gentamicin	confers no resistance to antibiotic after 18 hours
ydhJ	Ampicillin	confers no resistance to antibiotic after 18 hours
rlmL	Ampicillin	confers no resistance to antibiotic after 18 hours
gspO	Metronidazole	confers no resistance to antibiotic after 18 hours
ybdD	Rifampicin	confers no resistance to antibiotic after 18 hours
tesB	Sulfamethoxazole	confers no resistance to antibiotic after 18 hours
cra	Vancomycin	confers no resistance to antibiotic after 18 hours
pfkA	Sulfamethoxazole	confers no resistance to antibiotic after 18 hours
hcr	Vancomycin	confers no resistance to antibiotic after 18 hours
ybbN	Rifampicin	confers no resistance to antibiotic after 18 hours
yneF	Gentamicin	confers no resistance to antibiotic after 18 hours
pcm	Ampicillin	confers no resistance to antibiotic after 18 hours
yagN	Ampicillin	confers no resistance to antibiotic after 18 hours
gspF	Rifampicin	confers no resistance to antibiotic after 18 hours
rhlE	Ampicillin	confers no resistance to antibiotic after 18 hours
yebS	Ampicillin	confers no resistance to antibiotic after 18 hours
talB	Sulfamethoxazole	confers no resistance to antibiotic after 18 hours
fimA	Rifampicin	confers no resistance to antibiotic after 18 hours
ybhJ	Gentamicin	confers no resistance to antibiotic after 18 hours
yajI	Vancomycin	confers no resistance to antibiotic after 18 hours
ynfM	Rifampicin	confers no resistance to antibiotic after 18 hours
fliA	Vancomycin	confers no resistance to antibiotic after 18 hours
sgcQ	Vancomycin	confers no resistance to antibiotic after 18 hours
yicS	Ciprofloxacin	confers no resistance to antibiotic after 18 hours
tar	Ciprofloxacin	confers no resistance to antibiotic after 18 hours
ydaG	Rifampicin	confers no resistance to antibiotic after 18 hours
paaA	Gentamicin	confers no resistance to antibiotic after 18 hours
kch	Ciprofloxacin	confers no resistance to antibiotic after 18 hours
flgH	Gentamicin	confers no resistance to antibiotic after 18 hours
trpD	Rifampicin	confers no resistance to antibiotic after 18 hours
dsbA	Vancomycin	confers no resistance to antibiotic after 18 hours
yhhW	Gentamicin	confers no resistance to antibiotic after 18 hours
ymfH	Vancomycin	confers no resistance to antibiotic after 18 hours
hisM	Sulfamethoxazole	confers no resistance to antibiotic after 18 hours
ybiS	Vancomycin	confers no resistance to antibiotic after 18 hours
yfdY	Ciprofloxacin	confers no resistance to antibiotic after 18 hours
sgbE	Gentamicin	confers no resistance to antibiotic after 18 hours
hycH	Vancomycin	confers no resistance to antibiotic after 18 hours
relE	Vancomycin	confers no resistance to antibiotic after 18 hours
qmcA	Metronidazole	confers no resistance to antibiotic after 18 hours
ybjE	Sulfamethoxazole	confers no resistance to antibiotic after 18 hours
panD	Rifampicin	confers no resistance to antibiotic after 18 hours
frmR	Ciprofloxacin	confers no resistance to antibiotic after 18 hours
nohA	Gentamicin	confers no resistance to antibiotic after 18 hours
bolA	Gentamicin	confers no resistance to antibiotic after 18 hours
torS	Sulfamethoxazole	confers no resistance to antibiotic after 18 hours
pdxB	Rifampicin	confers no resistance to antibiotic after 18 hours
ygcQ	Gentamicin	confers no resistance to antibiotic after 18 hours
ygeM	Vancomycin	confers no resistance to antibiotic after 18 hours
yjhD	Sulfamethoxazole	confers no resistance to antibiotic after 18 hours
artM	Gentamicin	confers no resistance to antibiotic after 18 hours
ligT	Vancomycin	confers no resistance to antibiotic after 18 hours
yadN	Ampicillin	confers no resistance to antibiotic after 18 hours
cbeA	Rifampicin	confers no resistance to antibiotic after 18 hours
hisF	Ciprofloxacin	confers no resistance to antibiotic after 18 hours
ybeD	Ciprofloxacin	confers no resistance to antibiotic after 18 hours
ybiY	Metronidazole	confers no resistance to antibiotic after 18 hours
queE	Gentamicin	confers no resistance to antibiotic after 18 hours
metI	Rifampicin	confers no resistance to antibiotic after 18 hours
osmY	Ciprofloxacin	confers no resistance to antibiotic after 18 hours
yebO	Ciprofloxacin	confers no resistance to antibiotic after 18 hours
puuD	Sulfamethoxazole	confers no resistance to antibiotic after 18 hours
yfaW	Vancomycin	confers no resistance to antibiotic after 18 hours
aer	Ciprofloxacin	confers no resistance to antibiotic after 18 hours
sspA	Sulfamethoxazole	confers no resistance to antibiotic after 18 hours
tfaR	Vancomycin	confers no resistance to antibiotic after 18 hours
yjaA	Ciprofloxacin	confers no resistance to antibiotic after 18 hours
ydiF	Sulfamethoxazole	confers no resistance to antibiotic after 18 hours
xisE	Rifampicin	confers no resistance to antibiotic after 18 hours
adiC	Gentamicin	confers no resistance to antibiotic after 18 hours
cynR	Ampicillin	confers no resistance to antibiotic after 18 hours
yieF	Metronidazole	confers no resistance to antibiotic after 18 hours
nohB	Gentamicin	confers no resistance to antibiotic after 18 hours
pyrL	Gentamicin	confers no resistance to antibiotic after 18 hours
purM	Rifampicin	confers no resistance to antibiotic after 18 hours
pflC	Vancomycin	confers no resistance to antibiotic after 18 hours
yfcD	Ciprofloxacin	confers no resistance to antibiotic after 18 hours
iraD	Gentamicin	confers no resistance to antibiotic after 18 hours
cutC	Rifampicin	confers no resistance to antibiotic after 18 hours
yahE	Metronidazole	confers no resistance to antibiotic after 18 hours
ydiM	Vancomycin	confers no resistance to antibiotic after 18 hours
uacT	Sulfamethoxazole	confers no resistance to antibiotic after 18 hours
alaC	Gentamicin	confers no resistance to antibiotic after 18 hours
ytfB	Sulfamethoxazole	confers no resistance to antibiotic after 18 hours
ydcD	Sulfamethoxazole	confers no resistance to antibiotic after 18 hours
rsmA	Vancomycin	confers no resistance to antibiotic after 18 hours
yfaW	Ciprofloxacin	confers no resistance to antibiotic after 18 hours
pyrC	Ampicillin	confers no resistance to antibiotic after 18 hours
bglG	Vancomycin	confers no resistance to antibiotic after 18 hours
ybeT	Vancomycin	confers no resistance to antibiotic after 18 hours
nagE	Metronidazole	confers no resistance to antibiotic after 18 hours
lyxK	Metronidazole	confers no resistance to antibiotic after 18 hours
ykgF	Rifampicin	confers no resistance to antibiotic after 18 hours
rcsC	Sulfamethoxazole	confers no resistance to antibiotic after 18 hours
frwD	Rifampicin	confers no resistance to antibiotic after 18 hours
pgaA	Ciprofloxacin	confers no resistance to antibiotic after 18 hours
ebgC	Rifampicin	confers no resistance to antibiotic after 18 hours
ybeR	Gentamicin	confers no resistance to antibiotic after 18 hours
pstA	Sulfamethoxazole	confers resistance to antibiotic after 18 hours
kdpA	Vancomycin	confers no resistance to antibiotic after 18 hours
cdaR	Ampicillin	confers no resistance to antibiotic after 18 hours
yihX	Ciprofloxacin	confers no resistance to antibiotic after 18 hours
cueO	Rifampicin	confers no resistance to antibiotic after 18 hours
ybaL	Ciprofloxacin	confers no resistance to antibiotic after 18 hours
potH	Metronidazole	confers no resistance to antibiotic after 18 hours
cysG	Sulfamethoxazole	confers no resistance to antibiotic after 18 hours
yhcH	Gentamicin	confers no resistance to antibiotic after 18 hours
ytfK	Vancomycin	confers no resistance to antibiotic after 18 hours
modF	Sulfamethoxazole	confers no resistance to antibiotic after 18 hours
ydjM	Gentamicin	confers no resistance to antibiotic after 18 hours
nohB	Metronidazole	confers no resistance to antibiotic after 18 hours
yrbG	Ampicillin	confers no resistance to antibiotic after 18 hours
argO	Rifampicin	confers no resistance to antibiotic after 18 hours
yjbG	Vancomycin	confers no resistance to antibiotic after 18 hours
ygeI	Ampicillin	confers no resistance to antibiotic after 18 hours
yhiN	Sulfamethoxazole	confers no resistance to antibiotic after 18 hours
yedM	Rifampicin	confers no resistance to antibiotic after 18 hours
dmsD	Ampicillin	confers no resistance to antibiotic after 18 hours
emrE	Vancomycin	confers no resistance to antibiotic after 18 hours
lldD	Sulfamethoxazole	confers no resistance to antibiotic after 18 hours
yaeI	Ciprofloxacin	confers no resistance to antibiotic after 18 hours
yeeS	Ciprofloxacin	confers no resistance to antibiotic after 18 hours
uidC	Metronidazole	confers no resistance to antibiotic after 18 hours
ybgJ	Vancomycin	confers no resistance to antibiotic after 18 hours
wzb	Gentamicin	confers no resistance to antibiotic after 18 hours
sgbU	Sulfamethoxazole	confers no resistance to antibiotic after 18 hours
yqjK	Ciprofloxacin	confers no resistance to antibiotic after 18 hours
lsrA	Sulfamethoxazole	confers no resistance to antibiotic after 18 hours
pcm	Rifampicin	confers no resistance to antibiotic after 18 hours
rnr	Ampicillin	confers no resistance to antibiotic after 18 hours
mglB	Vancomycin	confers no resistance to antibiotic after 18 hours
glgX	Gentamicin	confers no resistance to antibiotic after 18 hours
hyfE	Metronidazole	confers no resistance to antibiotic after 18 hours
pka	Metronidazole	confers no resistance to antibiotic after 18 hours
napD	Gentamicin	confers no resistance to antibiotic after 18 hours
sgcB	Vancomycin	confers no resistance to antibiotic after 18 hours
ccmA	Metronidazole	confers no resistance to antibiotic after 18 hours
ybcI	Rifampicin	confers no resistance to antibiotic after 18 hours
yoaE	Gentamicin	confers no resistance to antibiotic after 18 hours
mepA	Ciprofloxacin	confers no resistance to antibiotic after 18 hours
ydjA	Vancomycin	confers no resistance to antibiotic after 18 hours
ynaA	Rifampicin	confers no resistance to antibiotic after 18 hours
ycdU	Vancomycin	confers no resistance to antibiotic after 18 hours
ybjJ	Gentamicin	confers no resistance to antibiotic after 18 hours
yghE	Gentamicin	confers no resistance to antibiotic after 18 hours
torI	Ampicillin	confers no resistance to antibiotic after 18 hours
trmL	Gentamicin	confers no resistance to antibiotic after 18 hours
rraA	Sulfamethoxazole	confers no resistance to antibiotic after 18 hours
apt	Ampicillin	confers no resistance to antibiotic after 18 hours
yiaC	Ciprofloxacin	confers no resistance to antibiotic after 18 hours
comR	Vancomycin	confers no resistance to antibiotic after 18 hours
yeeN	Sulfamethoxazole	confers no resistance to antibiotic after 18 hours
yjiP	Sulfamethoxazole	confers no resistance to antibiotic after 18 hours
tfaS	Vancomycin	confers no resistance to antibiotic after 18 hours
yadS	Rifampicin	confers no resistance to antibiotic after 18 hours
ybeU	Metronidazole	confers no resistance to antibiotic after 18 hours
wcaK	Sulfamethoxazole	confers no resistance to antibiotic after 18 hours
yjaB	Sulfamethoxazole	confers no resistance to antibiotic after 18 hours
matP	Rifampicin	confers no resistance to antibiotic after 18 hours
yhjR	Vancomycin	confers no resistance to antibiotic after 18 hours
mocA	Metronidazole	confers no resistance to antibiotic after 18 hours
bcsQ	Ciprofloxacin	confers no resistance to antibiotic after 18 hours
scpB	Ciprofloxacin	confers no resistance to antibiotic after 18 hours
dadA	Gentamicin	confers no resistance to antibiotic after 18 hours
gspC	Rifampicin	confers no resistance to antibiotic after 18 hours
glpD	Sulfamethoxazole	confers no resistance to antibiotic after 18 hours
htrL	Rifampicin	confers no resistance to antibiotic after 18 hours
rarA	Metronidazole	confers no resistance to antibiotic after 18 hours
yqhH	Gentamicin	confers no resistance to antibiotic after 18 hours
arfB	Sulfamethoxazole	confers no resistance to antibiotic after 18 hours
tolQ	Vancomycin	confers no resistance to antibiotic after 18 hours
nuoF	Gentamicin	confers no resistance to antibiotic after 18 hours
prmB	Sulfamethoxazole	confers no resistance to antibiotic after 18 hours
ybgD	Metronidazole	confers no resistance to antibiotic after 18 hours
mcrC	Ampicillin	confers no resistance to antibiotic after 18 hours
cheY	Ciprofloxacin	confers no resistance to antibiotic after 18 hours
cbrA	Ampicillin	confers no resistance to antibiotic after 18 hours
hypE	Sulfamethoxazole	confers no resistance to antibiotic after 18 hours
yciA	Metronidazole	confers no resistance to antibiotic after 18 hours
ycdT	Rifampicin	confers no resistance to antibiotic after 18 hours
selB	Rifampicin	confers no resistance to antibiotic after 18 hours
argA	Sulfamethoxazole	confers no resistance to antibiotic after 18 hours
yagX	Sulfamethoxazole	confers no resistance to antibiotic after 18 hours
argR	Ciprofloxacin	confers no resistance to antibiotic after 18 hours
purF	Metronidazole	confers no resistance to antibiotic after 18 hours
argI	Sulfamethoxazole	confers no resistance to antibiotic after 18 hours
ydaE	Sulfamethoxazole	confers no resistance to antibiotic after 18 hours
yhhH	Sulfamethoxazole	confers no resistance to antibiotic after 18 hours
bolA	Rifampicin	confers no resistance to antibiotic after 18 hours
yzcX	Ciprofloxacin	confers no resistance to antibiotic after 18 hours
sthA	Sulfamethoxazole	confers no resistance to antibiotic after 18 hours
npr	Vancomycin	confers no resistance to antibiotic after 18 hours
tusD	Ciprofloxacin	confers no resistance to antibiotic after 18 hours
yegL	Gentamicin	confers no resistance to antibiotic after 18 hours
rnb	Ampicillin	confers no resistance to antibiotic after 18 hours
ycjT	Ampicillin	confers no resistance to antibiotic after 18 hours
folB	Ciprofloxacin	confers no resistance to antibiotic after 18 hours
aroD	Ampicillin	confers no resistance to antibiotic after 18 hours
rlpA	Rifampicin	confers no resistance to antibiotic after 18 hours
argD	Sulfamethoxazole	confers no resistance to antibiotic after 18 hours
yqjG	Metronidazole	confers no resistance to antibiotic after 18 hours
malP	Ciprofloxacin	confers no resistance to antibiotic after 18 hours
yadN	Rifampicin	confers no resistance to antibiotic after 18 hours
ihfA	Sulfamethoxazole	confers no resistance to antibiotic after 18 hours
yccS	Sulfamethoxazole	confers no resistance to antibiotic after 18 hours
yigI	Ciprofloxacin	confers no resistance to antibiotic after 18 hours
yajC	Gentamicin	confers no resistance to antibiotic after 18 hours
yqeJ	Rifampicin	confers no resistance to antibiotic after 18 hours
bhsA	Ciprofloxacin	confers no resistance to antibiotic after 18 hours
purL	Gentamicin	confers no resistance to antibiotic after 18 hours
uidA	Sulfamethoxazole	confers no resistance to antibiotic after 18 hours
ygaU	Sulfamethoxazole	confers no resistance to antibiotic after 18 hours
ssuB	Metronidazole	confers no resistance to antibiotic after 18 hours
ybiW	Metronidazole	confers no resistance to antibiotic after 18 hours
sfsB	Metronidazole	confers no resistance to antibiotic after 18 hours
yafY	Gentamicin	confers no resistance to antibiotic after 18 hours
ygiZ	Vancomycin	confers no resistance to antibiotic after 18 hours
fadR	Metronidazole	confers no resistance to antibiotic after 18 hours
mutT	Ciprofloxacin	confers no resistance to antibiotic after 18 hours
napB	Rifampicin	confers no resistance to antibiotic after 18 hours
gcvP	Rifampicin	confers no resistance to antibiotic after 18 hours
hyaF	Metronidazole	confers no resistance to antibiotic after 18 hours
menC	Gentamicin	confers no resistance to antibiotic after 18 hours
ygcS	Sulfamethoxazole	confers no resistance to antibiotic after 18 hours
gstA	Ciprofloxacin	confers no resistance to antibiotic after 18 hours
bcsG	Ampicillin	confers no resistance to antibiotic after 18 hours
yqgC	Sulfamethoxazole	confers no resistance to antibiotic after 18 hours
ydhL	Rifampicin	confers no resistance to antibiotic after 18 hours
ppsR	Gentamicin	confers no resistance to antibiotic after 18 hours
ynfE	Gentamicin	confers no resistance to antibiotic after 18 hours
nhoA	Rifampicin	confers no resistance to antibiotic after 18 hours
anmK	Ampicillin	confers no resistance to antibiotic after 18 hours
fadK	Ciprofloxacin	confers no resistance to antibiotic after 18 hours
nudL	Rifampicin	confers no resistance to antibiotic after 18 hours
ptsP	Metronidazole	confers no resistance to antibiotic after 18 hours
yfjM	Ciprofloxacin	confers no resistance to antibiotic after 18 hours
rhsB	Rifampicin	confers no resistance to antibiotic after 18 hours
ycaR	Sulfamethoxazole	confers no resistance to antibiotic after 18 hours
dppB	Rifampicin	confers no resistance to antibiotic after 18 hours
ybgC	Ciprofloxacin	confers resistance to antibiotic after 18 hours
gltK	Rifampicin	confers no resistance to antibiotic after 18 hours
ycgL	Gentamicin	confers no resistance to antibiotic after 18 hours
ubiE	Gentamicin	confers no resistance to antibiotic after 18 hours
etp	Ampicillin	confers no resistance to antibiotic after 18 hours
yddA	Vancomycin	confers no resistance to antibiotic after 18 hours
yjjA	Ampicillin	confers no resistance to antibiotic after 18 hours
frdA	Ampicillin	confers no resistance to antibiotic after 18 hours
curA	Rifampicin	confers no resistance to antibiotic after 18 hours
xylH	Rifampicin	confers no resistance to antibiotic after 18 hours
ypjM_1	Vancomycin	confers no resistance to antibiotic after 18 hours
yqaA	Vancomycin	confers no resistance to antibiotic after 18 hours
yeaH	Ciprofloxacin	confers no resistance to antibiotic after 18 hours
yegV	Ciprofloxacin	confers no resistance to antibiotic after 18 hours
putA	Ciprofloxacin	confers no resistance to antibiotic after 18 hours
yghB	Sulfamethoxazole	confers no resistance to antibiotic after 18 hours
yhcG	Ciprofloxacin	confers no resistance to antibiotic after 18 hours
yafY	Metronidazole	confers no resistance to antibiotic after 18 hours
ychN	Metronidazole	confers no resistance to antibiotic after 18 hours
putP	Ciprofloxacin	confers no resistance to antibiotic after 18 hours
galS	Ciprofloxacin	confers no resistance to antibiotic after 18 hours
malE	Vancomycin	confers no resistance to antibiotic after 18 hours
yjiT	Metronidazole	confers no resistance to antibiotic after 18 hours
ynjF	Rifampicin	confers no resistance to antibiotic after 18 hours
ygaH	Gentamicin	confers no resistance to antibiotic after 18 hours
ymgF	Ampicillin	confers no resistance to antibiotic after 18 hours
yhcG	Metronidazole	confers no resistance to antibiotic after 18 hours
ygeM	Sulfamethoxazole	confers no resistance to antibiotic after 18 hours
holC	Vancomycin	confers no resistance to antibiotic after 18 hours
nohA	Vancomycin	confers no resistance to antibiotic after 18 hours
dam	Ciprofloxacin	confers no resistance to antibiotic after 18 hours
ydhZ	Metronidazole	confers no resistance to antibiotic after 18 hours
leuC	Rifampicin	confers no resistance to antibiotic after 18 hours
bfd	Ampicillin	confers no resistance to antibiotic after 18 hours
rtn	Gentamicin	confers no resistance to antibiotic after 18 hours
ydcD	Ampicillin	confers no resistance to antibiotic after 18 hours
mazG	Gentamicin	confers no resistance to antibiotic after 18 hours
yccF	Rifampicin	confers no resistance to antibiotic after 18 hours
gatD	Ciprofloxacin	confers no resistance to antibiotic after 18 hours
ymfA	Sulfamethoxazole	confers no resistance to antibiotic after 18 hours
ycjT	Rifampicin	confers no resistance to antibiotic after 18 hours
ydeT	Vancomycin	confers no resistance to antibiotic after 18 hours
lpxP	Vancomycin	confers no resistance to antibiotic after 18 hours
bdcR	Ampicillin	confers no resistance to antibiotic after 18 hours
yidD	Vancomycin	confers no resistance to antibiotic after 18 hours
pykA	Vancomycin	confers no resistance to antibiotic after 18 hours
hslR	Ampicillin	confers no resistance to antibiotic after 18 hours
yibN	Sulfamethoxazole	confers no resistance to antibiotic after 18 hours
dsdA	Ampicillin	confers no resistance to antibiotic after 18 hours
cueR	Vancomycin	confers no resistance to antibiotic after 18 hours
pepT	Vancomycin	confers no resistance to antibiotic after 18 hours
ydbA	Ciprofloxacin	confers no resistance to antibiotic after 18 hours
ygjV	Metronidazole	confers no resistance to antibiotic after 18 hours
yagU	Metronidazole	confers no resistance to antibiotic after 18 hours
pepE	Ciprofloxacin	confers no resistance to antibiotic after 18 hours
mlaD	Sulfamethoxazole	confers no resistance to antibiotic after 18 hours
appB	Rifampicin	confers no resistance to antibiotic after 18 hours
ugpC	Gentamicin	confers no resistance to antibiotic after 18 hours
yebT	Sulfamethoxazole	confers no resistance to antibiotic after 18 hours
yehT	Rifampicin	confers no resistance to antibiotic after 18 hours
yjcB	Ampicillin	confers no resistance to antibiotic after 18 hours
yghT	Vancomycin	confers no resistance to antibiotic after 18 hours
gcvR	Sulfamethoxazole	confers no resistance to antibiotic after 18 hours
yfaY	Ampicillin	confers no resistance to antibiotic after 18 hours
yjeN	Metronidazole	confers no resistance to antibiotic after 18 hours
lhgO	Sulfamethoxazole	confers no resistance to antibiotic after 18 hours
ydaE	Gentamicin	confers no resistance to antibiotic after 18 hours
pptA	Vancomycin	confers no resistance to antibiotic after 18 hours
csiR	Metronidazole	confers no resistance to antibiotic after 18 hours
bcsA	Gentamicin	confers no resistance to antibiotic after 18 hours
thiG	Rifampicin	confers no resistance to antibiotic after 18 hours
nudB	Metronidazole	confers resistance to antibiotic after 18 hours
fliS	Vancomycin	confers no resistance to antibiotic after 18 hours
nth	Rifampicin	confers no resistance to antibiotic after 18 hours
dcuS	Sulfamethoxazole	confers no resistance to antibiotic after 18 hours
galU	Ampicillin	confers no resistance to antibiotic after 18 hours
yagK	Ampicillin	confers no resistance to antibiotic after 18 hours
fepA	Ampicillin	confers no resistance to antibiotic after 18 hours
mutY	Gentamicin	confers no resistance to antibiotic after 18 hours
ibaG	Ciprofloxacin	confers no resistance to antibiotic after 18 hours
eutL	Vancomycin	confers no resistance to antibiotic after 18 hours
yadL	Rifampicin	confers no resistance to antibiotic after 18 hours
exbB	Sulfamethoxazole	confers no resistance to antibiotic after 18 hours
yigI	Gentamicin	confers no resistance to antibiotic after 18 hours
mtlD	Metronidazole	confers no resistance to antibiotic after 18 hours
yecH	Vancomycin	confers no resistance to antibiotic after 18 hours
hipA	Vancomycin	confers no resistance to antibiotic after 18 hours
trkH	Sulfamethoxazole	confers no resistance to antibiotic after 18 hours
aroD	Vancomycin	confers no resistance to antibiotic after 18 hours
potA	Sulfamethoxazole	confers no resistance to antibiotic after 18 hours
phnF	Gentamicin	confers no resistance to antibiotic after 18 hours
mdaB	Metronidazole	confers no resistance to antibiotic after 18 hours
hokE	Vancomycin	confers no resistance to antibiotic after 18 hours
murQ	Sulfamethoxazole	confers no resistance to antibiotic after 18 hours
modA	Metronidazole	confers no resistance to antibiotic after 18 hours
phnM	Ampicillin	confers no resistance to antibiotic after 18 hours
eutT	Vancomycin	confers no resistance to antibiotic after 18 hours
lipA	Metronidazole	confers no resistance to antibiotic after 18 hours
zntA	Ciprofloxacin	confers no resistance to antibiotic after 18 hours
tgt	Ampicillin	confers no resistance to antibiotic after 18 hours
rlmD	Gentamicin	confers no resistance to antibiotic after 18 hours
hcaF	Rifampicin	confers no resistance to antibiotic after 18 hours
gntX	Ciprofloxacin	confers no resistance to antibiotic after 18 hours
rimL	Gentamicin	confers no resistance to antibiotic after 18 hours
yfcV	Rifampicin	confers no resistance to antibiotic after 18 hours
ftnA	Ampicillin	confers no resistance to antibiotic after 18 hours
citF	Ampicillin	confers no resistance to antibiotic after 18 hours
ydiQ	Rifampicin	confers no resistance to antibiotic after 18 hours
hslU	Vancomycin	confers no resistance to antibiotic after 18 hours
yccE	Rifampicin	confers no resistance to antibiotic after 18 hours
yhbP	Ampicillin	confers no resistance to antibiotic after 18 hours
entB	Metronidazole	confers no resistance to antibiotic after 18 hours
yedM	Gentamicin	confers no resistance to antibiotic after 18 hours
yqeB	Sulfamethoxazole	confers no resistance to antibiotic after 18 hours
ypjF	Metronidazole	confers no resistance to antibiotic after 18 hours
yhjJ	Ampicillin	confers no resistance to antibiotic after 18 hours
waaP	Ciprofloxacin	confers no resistance to antibiotic after 18 hours
hlpA	Metronidazole	confers resistance to antibiotic after 18 hours
ycjF	Gentamicin	confers no resistance to antibiotic after 18 hours
yfcZ	Ciprofloxacin	confers no resistance to antibiotic after 18 hours
efeO	Ampicillin	confers no resistance to antibiotic after 18 hours
hisD	Sulfamethoxazole	confers no resistance to antibiotic after 18 hours
rluB	Vancomycin	confers no resistance to antibiotic after 18 hours
ydcL	Rifampicin	confers no resistance to antibiotic after 18 hours
tdcG	Ampicillin	confers no resistance to antibiotic after 18 hours
thyA	Gentamicin	confers no resistance to antibiotic after 18 hours
yaiV	Sulfamethoxazole	confers no resistance to antibiotic after 18 hours
btuR	Vancomycin	confers no resistance to antibiotic after 18 hours
fliM	Rifampicin	confers no resistance to antibiotic after 18 hours
ssuE	Metronidazole	confers no resistance to antibiotic after 18 hours
pncB	Rifampicin	confers no resistance to antibiotic after 18 hours
rpmJ	Vancomycin	confers resistance to antibiotic after 18 hours
nikB	Gentamicin	confers no resistance to antibiotic after 18 hours
yfgI	Ciprofloxacin	confers no resistance to antibiotic after 18 hours
purM	Ciprofloxacin	confers no resistance to antibiotic after 18 hours
yncM	Gentamicin	confers no resistance to antibiotic after 18 hours
glnA	Metronidazole	confers no resistance to antibiotic after 18 hours
ygjP	Vancomycin	confers no resistance to antibiotic after 18 hours
yhhT	Metronidazole	confers no resistance to antibiotic after 18 hours
yicI	Metronidazole	confers no resistance to antibiotic after 18 hours
dsbG	Rifampicin	confers no resistance to antibiotic after 18 hours
allR	Ciprofloxacin	confers no resistance to antibiotic after 18 hours
pyrD	Rifampicin	confers no resistance to antibiotic after 18 hours
yhfU	Rifampicin	confers no resistance to antibiotic after 18 hours
smf	Metronidazole	confers no resistance to antibiotic after 18 hours
ycfS	Rifampicin	confers no resistance to antibiotic after 18 hours
yjdC	Rifampicin	confers no resistance to antibiotic after 18 hours
yhfK	Vancomycin	confers no resistance to antibiotic after 18 hours
argD	Gentamicin	confers no resistance to antibiotic after 18 hours
ykfA	Sulfamethoxazole	confers no resistance to antibiotic after 18 hours
yobD	Ampicillin	confers no resistance to antibiotic after 18 hours
ybeT	Sulfamethoxazole	confers no resistance to antibiotic after 18 hours
sapF	Metronidazole	confers no resistance to antibiotic after 18 hours
kdsC	Vancomycin	confers no resistance to antibiotic after 18 hours
yjjG	Vancomycin	confers no resistance to antibiotic after 18 hours
ybiC	Ciprofloxacin	confers no resistance to antibiotic after 18 hours
fsaB	Ampicillin	confers no resistance to antibiotic after 18 hours
katG	Gentamicin	confers no resistance to antibiotic after 18 hours
proC	Vancomycin	confers no resistance to antibiotic after 18 hours
lit	Ampicillin	confers no resistance to antibiotic after 18 hours
parC	Sulfamethoxazole	confers no resistance to antibiotic after 18 hours
rsxC	Metronidazole	confers no resistance to antibiotic after 18 hours
mobA	Metronidazole	confers no resistance to antibiotic after 18 hours
argH	Gentamicin	confers no resistance to antibiotic after 18 hours
yjfF	Metronidazole	confers no resistance to antibiotic after 18 hours
yfcJ	Ciprofloxacin	confers no resistance to antibiotic after 18 hours
yccE	Ciprofloxacin	confers no resistance to antibiotic after 18 hours
yeiQ	Gentamicin	confers no resistance to antibiotic after 18 hours
recA	Gentamicin	confers no resistance to antibiotic after 18 hours
ihfA	Ampicillin	confers no resistance to antibiotic after 18 hours
ompN	Vancomycin	confers no resistance to antibiotic after 18 hours
narX	Ampicillin	confers no resistance to antibiotic after 18 hours
nfrA	Metronidazole	confers no resistance to antibiotic after 18 hours
gnsB	Gentamicin	confers no resistance to antibiotic after 18 hours
puuA	Vancomycin	confers no resistance to antibiotic after 18 hours
yfaZ	Ampicillin	confers no resistance to antibiotic after 18 hours
pmbA	Ciprofloxacin	confers no resistance to antibiotic after 18 hours
yeiE	Sulfamethoxazole	confers no resistance to antibiotic after 18 hours
frdA	Ciprofloxacin	confers no resistance to antibiotic after 18 hours
hcaF	Vancomycin	confers no resistance to antibiotic after 18 hours
ydeP	Gentamicin	confers no resistance to antibiotic after 18 hours
yhhI	Ciprofloxacin	confers no resistance to antibiotic after 18 hours
ydbL	Sulfamethoxazole	confers no resistance to antibiotic after 18 hours
nrdF	Gentamicin	confers no resistance to antibiotic after 18 hours
ybhM	Rifampicin	confers no resistance to antibiotic after 18 hours
ybaN	Gentamicin	confers no resistance to antibiotic after 18 hours
yehX	Gentamicin	confers no resistance to antibiotic after 18 hours
ynjF	Ampicillin	confers no resistance to antibiotic after 18 hours
atl	Sulfamethoxazole	confers no resistance to antibiotic after 18 hours
caiB	Ciprofloxacin	confers no resistance to antibiotic after 18 hours
frvX	Rifampicin	confers no resistance to antibiotic after 18 hours
plaP	Ciprofloxacin	confers no resistance to antibiotic after 18 hours
ldhA	Gentamicin	confers no resistance to antibiotic after 18 hours
frdC	Gentamicin	confers no resistance to antibiotic after 18 hours
sra	Ampicillin	confers no resistance to antibiotic after 18 hours
luxS	Ciprofloxacin	confers no resistance to antibiotic after 18 hours
yodC	Ciprofloxacin	confers no resistance to antibiotic after 18 hours
nupC	Sulfamethoxazole	confers no resistance to antibiotic after 18 hours
puuB	Rifampicin	confers no resistance to antibiotic after 18 hours
otsA	Metronidazole	confers no resistance to antibiotic after 18 hours
elaD	Rifampicin	confers resistance to antibiotic after 18 hours
glrK	Vancomycin	confers no resistance to antibiotic after 18 hours
hisC	Rifampicin	confers no resistance to antibiotic after 18 hours
tolQ	Ampicillin	confers no resistance to antibiotic after 18 hours
tmcA	Rifampicin	confers no resistance to antibiotic after 18 hours
ygdQ	Metronidazole	confers no resistance to antibiotic after 18 hours
ycdY	Metronidazole	confers no resistance to antibiotic after 18 hours
ybcO	Vancomycin	confers no resistance to antibiotic after 18 hours
ybeM	Sulfamethoxazole	confers no resistance to antibiotic after 18 hours
trkA	Sulfamethoxazole	confers no resistance to antibiotic after 18 hours
gspK	Metronidazole	confers no resistance to antibiotic after 18 hours
rcsC	Gentamicin	confers no resistance to antibiotic after 18 hours
ybgK	Metronidazole	confers no resistance to antibiotic after 18 hours
phoA	Ampicillin	confers no resistance to antibiotic after 18 hours
yqeI	Metronidazole	confers no resistance to antibiotic after 18 hours
sapA	Rifampicin	confers no resistance to antibiotic after 18 hours
yjgW	Vancomycin	confers no resistance to antibiotic after 18 hours
pdxH	Ampicillin	confers no resistance to antibiotic after 18 hours
ymgF	Metronidazole	confers no resistance to antibiotic after 18 hours
ybiU	Ciprofloxacin	confers no resistance to antibiotic after 18 hours
yibA	Gentamicin	confers no resistance to antibiotic after 18 hours
dcyD	Sulfamethoxazole	confers no resistance to antibiotic after 18 hours
yoeF	Sulfamethoxazole	confers no resistance to antibiotic after 18 hours
bglA	Rifampicin	confers no resistance to antibiotic after 18 hours
ymgD	Gentamicin	confers no resistance to antibiotic after 18 hours
ygjQ	Sulfamethoxazole	confers no resistance to antibiotic after 18 hours
entH	Rifampicin	confers no resistance to antibiotic after 18 hours
tyrA	Ciprofloxacin	confers no resistance to antibiotic after 18 hours
ychH	Ciprofloxacin	confers no resistance to antibiotic after 18 hours
arnT	Sulfamethoxazole	confers no resistance to antibiotic after 18 hours
rhaR	Sulfamethoxazole	confers no resistance to antibiotic after 18 hours
galT	Metronidazole	confers no resistance to antibiotic after 18 hours
mutT	Gentamicin	confers no resistance to antibiotic after 18 hours
rarA	Sulfamethoxazole	confers no resistance to antibiotic after 18 hours
yahL	Rifampicin	confers no resistance to antibiotic after 18 hours
ptsI	Gentamicin	confers no resistance to antibiotic after 18 hours
ydjY	Metronidazole	confers no resistance to antibiotic after 18 hours
ypdC	Gentamicin	confers no resistance to antibiotic after 18 hours
yiaL	Metronidazole	confers no resistance to antibiotic after 18 hours
rcnB	Ampicillin	confers no resistance to antibiotic after 18 hours
wbbI	Gentamicin	confers no resistance to antibiotic after 18 hours
ygdQ	Ciprofloxacin	confers no resistance to antibiotic after 18 hours
endA	Rifampicin	confers no resistance to antibiotic after 18 hours
envZ	Sulfamethoxazole	confers no resistance to antibiotic after 18 hours
talB	Vancomycin	confers no resistance to antibiotic after 18 hours
yjdK	Vancomycin	confers no resistance to antibiotic after 18 hours
gntR	Ampicillin	confers no resistance to antibiotic after 18 hours
mppA	Sulfamethoxazole	confers no resistance to antibiotic after 18 hours
mbhA	Ciprofloxacin	confers no resistance to antibiotic after 18 hours
fcl	Ampicillin	confers no resistance to antibiotic after 18 hours
ydjN	Sulfamethoxazole	confers no resistance to antibiotic after 18 hours
ybiA	Ampicillin	confers no resistance to antibiotic after 18 hours
glgB	Vancomycin	confers no resistance to antibiotic after 18 hours
rhsB	Sulfamethoxazole	confers no resistance to antibiotic after 18 hours
ydhP	Ampicillin	confers no resistance to antibiotic after 18 hours
malK	Ampicillin	confers no resistance to antibiotic after 18 hours
mtfA	Vancomycin	confers no resistance to antibiotic after 18 hours
pdxA	Ciprofloxacin	confers no resistance to antibiotic after 18 hours
emrD	Gentamicin	confers no resistance to antibiotic after 18 hours
yeaK	Ampicillin	confers no resistance to antibiotic after 18 hours
intF	Gentamicin	confers no resistance to antibiotic after 18 hours
yqjH	Rifampicin	confers no resistance to antibiotic after 18 hours
glnG	Ampicillin	confers no resistance to antibiotic after 18 hours
appC	Ciprofloxacin	confers no resistance to antibiotic after 18 hours
arcB	Sulfamethoxazole	confers no resistance to antibiotic after 18 hours
ycbK	Metronidazole	confers no resistance to antibiotic after 18 hours
citC	Ciprofloxacin	confers no resistance to antibiotic after 18 hours
nagA	Sulfamethoxazole	confers no resistance to antibiotic after 18 hours
ybdM	Vancomycin	confers no resistance to antibiotic after 18 hours
rseC	Sulfamethoxazole	confers no resistance to antibiotic after 18 hours
hdeD	Ciprofloxacin	confers no resistance to antibiotic after 18 hours
thrL	Vancomycin	confers no resistance to antibiotic after 18 hours
fimZ	Ampicillin	confers no resistance to antibiotic after 18 hours
ypdE	Rifampicin	confers no resistance to antibiotic after 18 hours
fucR	Rifampicin	confers no resistance to antibiotic after 18 hours
tyrP	Gentamicin	confers no resistance to antibiotic after 18 hours
bioD	Ampicillin	confers no resistance to antibiotic after 18 hours
yihX	Ampicillin	confers no resistance to antibiotic after 18 hours
yibG	Ampicillin	confers no resistance to antibiotic after 18 hours
fruA	Gentamicin	confers no resistance to antibiotic after 18 hours
yqhG	Sulfamethoxazole	confers no resistance to antibiotic after 18 hours
atoC	Ciprofloxacin	confers no resistance to antibiotic after 18 hours
yfcJ	Rifampicin	confers no resistance to antibiotic after 18 hours
recG	Ciprofloxacin	confers resistance to antibiotic after 18 hours
ybgQ	Sulfamethoxazole	confers no resistance to antibiotic after 18 hours
tolR	Rifampicin	confers resistance to antibiotic after 18 hours
ypjA	Gentamicin	confers no resistance to antibiotic after 18 hours
yebW	Ampicillin	confers no resistance to antibiotic after 18 hours
cysA	Vancomycin	confers no resistance to antibiotic after 18 hours
recA	Metronidazole	confers resistance to antibiotic after 18 hours
yhgF	Gentamicin	confers no resistance to antibiotic after 18 hours
hdhA	Metronidazole	confers no resistance to antibiotic after 18 hours
pgrR	Ampicillin	confers no resistance to antibiotic after 18 hours
ldcA	Gentamicin	confers no resistance to antibiotic after 18 hours
glnA	Rifampicin	confers no resistance to antibiotic after 18 hours
glxK	Sulfamethoxazole	confers no resistance to antibiotic after 18 hours
mipA	Ciprofloxacin	confers no resistance to antibiotic after 18 hours
ybeM	Ampicillin	confers no resistance to antibiotic after 18 hours
nrdI	Ampicillin	confers no resistance to antibiotic after 18 hours
ycjW	Ampicillin	confers no resistance to antibiotic after 18 hours
napF	Ampicillin	confers no resistance to antibiotic after 18 hours
ves	Rifampicin	confers no resistance to antibiotic after 18 hours
hcaE	Vancomycin	confers no resistance to antibiotic after 18 hours
yadD	Vancomycin	confers no resistance to antibiotic after 18 hours
rlmC	Ampicillin	confers no resistance to antibiotic after 18 hours
ycgI	Metronidazole	confers no resistance to antibiotic after 18 hours
deoB	Metronidazole	confers no resistance to antibiotic after 18 hours
garR	Metronidazole	confers no resistance to antibiotic after 18 hours
pstS	Vancomycin	confers no resistance to antibiotic after 18 hours
rhtA	Rifampicin	confers no resistance to antibiotic after 18 hours
entC	Metronidazole	confers no resistance to antibiotic after 18 hours
yicC	Metronidazole	confers no resistance to antibiotic after 18 hours
allE	Metronidazole	confers no resistance to antibiotic after 18 hours
ykgH	Vancomycin	confers no resistance to antibiotic after 18 hours
hisI	Gentamicin	confers no resistance to antibiotic after 18 hours
ydiH	Ciprofloxacin	confers no resistance to antibiotic after 18 hours
hslJ	Sulfamethoxazole	confers no resistance to antibiotic after 18 hours
flgB	Ciprofloxacin	confers no resistance to antibiotic after 18 hours
ygiV	Ampicillin	confers no resistance to antibiotic after 18 hours
glnG	Sulfamethoxazole	confers no resistance to antibiotic after 18 hours
btuC	Vancomycin	confers no resistance to antibiotic after 18 hours
minC	Vancomycin	confers no resistance to antibiotic after 18 hours
yjbQ	Ciprofloxacin	confers no resistance to antibiotic after 18 hours
hinT	Rifampicin	confers no resistance to antibiotic after 18 hours
yhjC	Ciprofloxacin	confers no resistance to antibiotic after 18 hours
ompF	Sulfamethoxazole	confers no resistance to antibiotic after 18 hours
sad	Rifampicin	confers no resistance to antibiotic after 18 hours
fdnH	Sulfamethoxazole	confers no resistance to antibiotic after 18 hours
yhfZ	Ampicillin	confers no resistance to antibiotic after 18 hours
yhjJ	Sulfamethoxazole	confers no resistance to antibiotic after 18 hours
nuoL	Vancomycin	confers no resistance to antibiotic after 18 hours
ybiP	Sulfamethoxazole	confers no resistance to antibiotic after 18 hours
yfaV	Metronidazole	confers no resistance to antibiotic after 18 hours
rsmH	Rifampicin	confers no resistance to antibiotic after 18 hours
iraP	Rifampicin	confers no resistance to antibiotic after 18 hours
chaB	Ampicillin	confers no resistance to antibiotic after 18 hours
ydfH	Sulfamethoxazole	confers no resistance to antibiotic after 18 hours
ydiP	Gentamicin	confers no resistance to antibiotic after 18 hours
coaE	Rifampicin	confers no resistance to antibiotic after 18 hours
insO	Metronidazole	confers no resistance to antibiotic after 18 hours
yedL	Rifampicin	confers no resistance to antibiotic after 18 hours
ydjM	Rifampicin	confers no resistance to antibiotic after 18 hours
uxaC	Ampicillin	confers no resistance to antibiotic after 18 hours
rlmD	Ampicillin	confers no resistance to antibiotic after 18 hours
argK	Ampicillin	confers no resistance to antibiotic after 18 hours
ybgK	Rifampicin	confers no resistance to antibiotic after 18 hours
yecE	Ciprofloxacin	confers no resistance to antibiotic after 18 hours
yihU	Sulfamethoxazole	confers no resistance to antibiotic after 18 hours
yehX	Vancomycin	confers no resistance to antibiotic after 18 hours
ycfZ	Gentamicin	confers no resistance to antibiotic after 18 hours
fliD	Metronidazole	confers no resistance to antibiotic after 18 hours
amtB	Ciprofloxacin	confers no resistance to antibiotic after 18 hours
relE	Gentamicin	confers no resistance to antibiotic after 18 hours
yciU	Ampicillin	confers no resistance to antibiotic after 18 hours
cadA	Metronidazole	confers no resistance to antibiotic after 18 hours
phnP	Sulfamethoxazole	confers no resistance to antibiotic after 18 hours
ydfA	Ciprofloxacin	confers no resistance to antibiotic after 18 hours
dgoD	Sulfamethoxazole	confers no resistance to antibiotic after 18 hours
yfaL	Vancomycin	confers no resistance to antibiotic after 18 hours
yjaA	Metronidazole	confers no resistance to antibiotic after 18 hours
rutR	Rifampicin	confers no resistance to antibiotic after 18 hours
yjfL	Metronidazole	confers no resistance to antibiotic after 18 hours
cdh	Ciprofloxacin	confers no resistance to antibiotic after 18 hours
amiD	Ciprofloxacin	confers no resistance to antibiotic after 18 hours
hycI	Sulfamethoxazole	confers no resistance to antibiotic after 18 hours
dmsC	Ampicillin	confers no resistance to antibiotic after 18 hours
pykF	Metronidazole	confers no resistance to antibiotic after 18 hours
ilvG	Metronidazole	confers no resistance to antibiotic after 18 hours
kbl	Sulfamethoxazole	confers no resistance to antibiotic after 18 hours
pppA	Ciprofloxacin	confers no resistance to antibiotic after 18 hours
gudP	Ampicillin	confers no resistance to antibiotic after 18 hours
cusR	Rifampicin	confers no resistance to antibiotic after 18 hours
phnE_1	Ampicillin	confers no resistance to antibiotic after 18 hours
dgcZ	Gentamicin	confers no resistance to antibiotic after 18 hours
wbbI	Sulfamethoxazole	confers no resistance to antibiotic after 18 hours
hicA	Gentamicin	confers no resistance to antibiotic after 18 hours
yjbL	Metronidazole	confers no resistance to antibiotic after 18 hours
rcsA	Sulfamethoxazole	confers no resistance to antibiotic after 18 hours
ygcR	Gentamicin	confers no resistance to antibiotic after 18 hours
yfdF	Metronidazole	confers no resistance to antibiotic after 18 hours
ybiC	Gentamicin	confers no resistance to antibiotic after 18 hours
asnB	Ampicillin	confers no resistance to antibiotic after 18 hours
ynjB	Ampicillin	confers no resistance to antibiotic after 18 hours
bglG	Ciprofloxacin	confers no resistance to antibiotic after 18 hours
bglH	Ampicillin	confers no resistance to antibiotic after 18 hours
ybjI	Vancomycin	confers no resistance to antibiotic after 18 hours
pheL	Ampicillin	confers no resistance to antibiotic after 18 hours
pepT	Gentamicin	confers no resistance to antibiotic after 18 hours
elaA	Metronidazole	confers no resistance to antibiotic after 18 hours
yjaH	Rifampicin	confers no resistance to antibiotic after 18 hours
yibI	Gentamicin	confers no resistance to antibiotic after 18 hours
yobH	Gentamicin	confers no resistance to antibiotic after 18 hours
ybbO	Vancomycin	confers no resistance to antibiotic after 18 hours
glpK	Rifampicin	confers no resistance to antibiotic after 18 hours
appA	Ampicillin	confers no resistance to antibiotic after 18 hours
yagW	Gentamicin	confers no resistance to antibiotic after 18 hours
setB	Sulfamethoxazole	confers no resistance to antibiotic after 18 hours
yfaT	Sulfamethoxazole	confers no resistance to antibiotic after 18 hours
citE	Ciprofloxacin	confers no resistance to antibiotic after 18 hours
yfeN	Gentamicin	confers no resistance to antibiotic after 18 hours
yfdC	Vancomycin	confers no resistance to antibiotic after 18 hours
ycfL	Rifampicin	confers no resistance to antibiotic after 18 hours
sfmF	Ampicillin	confers no resistance to antibiotic after 18 hours
araH	Ciprofloxacin	confers no resistance to antibiotic after 18 hours
add	Gentamicin	confers no resistance to antibiotic after 18 hours
yciH	Vancomycin	confers no resistance to antibiotic after 18 hours
idnD	Metronidazole	confers no resistance to antibiotic after 18 hours
cbl	Gentamicin	confers no resistance to antibiotic after 18 hours
fieF	Metronidazole	confers no resistance to antibiotic after 18 hours
pheM	Sulfamethoxazole	confers no resistance to antibiotic after 18 hours
ilvI	Vancomycin	confers no resistance to antibiotic after 18 hours
glvC	Ciprofloxacin	confers no resistance to antibiotic after 18 hours
ybcY	Gentamicin	confers no resistance to antibiotic after 18 hours
potE	Rifampicin	confers no resistance to antibiotic after 18 hours
ymfM	Rifampicin	confers no resistance to antibiotic after 18 hours
yegX	Vancomycin	confers no resistance to antibiotic after 18 hours
sulA	Rifampicin	confers no resistance to antibiotic after 18 hours
yaeP	Sulfamethoxazole	confers no resistance to antibiotic after 18 hours
ybaQ	Vancomycin	confers no resistance to antibiotic after 18 hours
bamE	Gentamicin	confers no resistance to antibiotic after 18 hours
yfgJ	Metronidazole	confers no resistance to antibiotic after 18 hours
yjdK	Rifampicin	confers no resistance to antibiotic after 18 hours
mnmC	Sulfamethoxazole	confers no resistance to antibiotic after 18 hours
ybeU	Sulfamethoxazole	confers no resistance to antibiotic after 18 hours
sgbU	Vancomycin	confers no resistance to antibiotic after 18 hours
argE	Rifampicin	confers no resistance to antibiotic after 18 hours
rsxD	Gentamicin	confers no resistance to antibiotic after 18 hours
dmlA	Vancomycin	confers no resistance to antibiotic after 18 hours
yniD	Rifampicin	confers no resistance to antibiotic after 18 hours
yceD	Rifampicin	confers resistance to antibiotic after 18 hours
rfe	Ciprofloxacin	confers no resistance to antibiotic after 18 hours
intE	Ciprofloxacin	confers no resistance to antibiotic after 18 hours
paaK	Ciprofloxacin	confers no resistance to antibiotic after 18 hours
yzcX	Gentamicin	confers no resistance to antibiotic after 18 hours
clpA	Rifampicin	confers no resistance to antibiotic after 18 hours
yfhM	Rifampicin	confers no resistance to antibiotic after 18 hours
ycaC	Sulfamethoxazole	confers no resistance to antibiotic after 18 hours
yhcB	Rifampicin	confers no resistance to antibiotic after 18 hours
proY	Metronidazole	confers no resistance to antibiotic after 18 hours
yhcC	Ampicillin	confers no resistance to antibiotic after 18 hours
djlC	Metronidazole	confers no resistance to antibiotic after 18 hours
hofN	Sulfamethoxazole	confers no resistance to antibiotic after 18 hours
greA	Vancomycin	confers no resistance to antibiotic after 18 hours
ydbC	Gentamicin	confers no resistance to antibiotic after 18 hours
lpxT	Vancomycin	confers no resistance to antibiotic after 18 hours
gatY	Vancomycin	confers no resistance to antibiotic after 18 hours
gapC	Gentamicin	confers no resistance to antibiotic after 18 hours
yehU	Metronidazole	confers no resistance to antibiotic after 18 hours
solA	Ampicillin	confers no resistance to antibiotic after 18 hours
damX	Vancomycin	confers no resistance to antibiotic after 18 hours
yoaD	Sulfamethoxazole	confers no resistance to antibiotic after 18 hours
ygiB	Ciprofloxacin	confers no resistance to antibiotic after 18 hours
ykfF	Gentamicin	confers no resistance to antibiotic after 18 hours
yrhC	Ciprofloxacin	confers no resistance to antibiotic after 18 hours
sapB	Ampicillin	confers no resistance to antibiotic after 18 hours
yafO	Vancomycin	confers no resistance to antibiotic after 18 hours
fhuE	Vancomycin	confers no resistance to antibiotic after 18 hours
symE	Rifampicin	confers no resistance to antibiotic after 18 hours
ydbD	Ciprofloxacin	confers no resistance to antibiotic after 18 hours
potB	Vancomycin	confers no resistance to antibiotic after 18 hours
yicH	Sulfamethoxazole	confers no resistance to antibiotic after 18 hours
malZ	Sulfamethoxazole	confers no resistance to antibiotic after 18 hours
fliA	Rifampicin	confers no resistance to antibiotic after 18 hours
fur	Rifampicin	confers no resistance to antibiotic after 18 hours
yaiY	Rifampicin	confers no resistance to antibiotic after 18 hours
yeeS	Vancomycin	confers no resistance to antibiotic after 18 hours
yedE	Sulfamethoxazole	confers no resistance to antibiotic after 18 hours
yraK	Vancomycin	confers no resistance to antibiotic after 18 hours
ybfG	Sulfamethoxazole	confers no resistance to antibiotic after 18 hours
yjbR	Vancomycin	confers no resistance to antibiotic after 18 hours
pdxH	Ciprofloxacin	confers no resistance to antibiotic after 18 hours
fadM	Vancomycin	confers no resistance to antibiotic after 18 hours
garL	Gentamicin	confers no resistance to antibiotic after 18 hours
uspF	Ampicillin	confers no resistance to antibiotic after 18 hours
yccA	Ciprofloxacin	confers no resistance to antibiotic after 18 hours
yjjK	Ampicillin	confers no resistance to antibiotic after 18 hours
hicB	Gentamicin	confers no resistance to antibiotic after 18 hours
yjiM	Vancomycin	confers no resistance to antibiotic after 18 hours
tamB	Gentamicin	confers no resistance to antibiotic after 18 hours
kdpA	Gentamicin	confers no resistance to antibiotic after 18 hours
aroK	Sulfamethoxazole	confers no resistance to antibiotic after 18 hours
ymdF	Sulfamethoxazole	confers no resistance to antibiotic after 18 hours
folX	Rifampicin	confers no resistance to antibiotic after 18 hours
hscB	Rifampicin	confers no resistance to antibiotic after 18 hours
yhjA	Vancomycin	confers no resistance to antibiotic after 18 hours
yphH	Rifampicin	confers no resistance to antibiotic after 18 hours
ygfQ	Vancomycin	confers no resistance to antibiotic after 18 hours
yjeF	Metronidazole	confers no resistance to antibiotic after 18 hours
fliP	Ampicillin	confers no resistance to antibiotic after 18 hours
gloA	Vancomycin	confers no resistance to antibiotic after 18 hours
yhdY	Metronidazole	confers no resistance to antibiotic after 18 hours
yjcE	Sulfamethoxazole	confers no resistance to antibiotic after 18 hours
apaG	Sulfamethoxazole	confers no resistance to antibiotic after 18 hours
wzzE	Rifampicin	confers no resistance to antibiotic after 18 hours
xseB	Gentamicin	confers no resistance to antibiotic after 18 hours
ybjL	Ampicillin	confers no resistance to antibiotic after 18 hours
ycaC	Vancomycin	confers no resistance to antibiotic after 18 hours
ydcN	Ciprofloxacin	confers no resistance to antibiotic after 18 hours
yghS	Ampicillin	confers no resistance to antibiotic after 18 hours
nanA	Ampicillin	confers no resistance to antibiotic after 18 hours
ybfE	Rifampicin	confers no resistance to antibiotic after 18 hours
mmuP	Ampicillin	confers no resistance to antibiotic after 18 hours
ttcA	Rifampicin	confers no resistance to antibiotic after 18 hours
yjgW	Metronidazole	confers no resistance to antibiotic after 18 hours
lsrG	Sulfamethoxazole	confers no resistance to antibiotic after 18 hours
modA	Ciprofloxacin	confers no resistance to antibiotic after 18 hours
fimF	Rifampicin	confers no resistance to antibiotic after 18 hours
ybdG	Sulfamethoxazole	confers no resistance to antibiotic after 18 hours
yobA	Sulfamethoxazole	confers no resistance to antibiotic after 18 hours
rbsA	Ciprofloxacin	confers no resistance to antibiotic after 18 hours
ilvA	Ciprofloxacin	confers no resistance to antibiotic after 18 hours
ydhJ	Rifampicin	confers no resistance to antibiotic after 18 hours
rbsC	Metronidazole	confers no resistance to antibiotic after 18 hours
ybhQ	Gentamicin	confers no resistance to antibiotic after 18 hours
nrfC	Metronidazole	confers no resistance to antibiotic after 18 hours
ytfJ	Ciprofloxacin	confers no resistance to antibiotic after 18 hours
eutR	Gentamicin	confers no resistance to antibiotic after 18 hours
flgB	Gentamicin	confers no resistance to antibiotic after 18 hours
ppdA	Vancomycin	confers no resistance to antibiotic after 18 hours
yqiA	Metronidazole	confers no resistance to antibiotic after 18 hours
nuoK	Gentamicin	confers no resistance to antibiotic after 18 hours
ymjB	Rifampicin	confers no resistance to antibiotic after 18 hours
yphF	Sulfamethoxazole	confers no resistance to antibiotic after 18 hours
norR	Ciprofloxacin	confers no resistance to antibiotic after 18 hours
lysR	Gentamicin	confers no resistance to antibiotic after 18 hours
lldD	Metronidazole	confers no resistance to antibiotic after 18 hours
yqiK	Ampicillin	confers no resistance to antibiotic after 18 hours
ymfQ	Ampicillin	confers no resistance to antibiotic after 18 hours
fepD	Gentamicin	confers no resistance to antibiotic after 18 hours
ycbL	Sulfamethoxazole	confers no resistance to antibiotic after 18 hours
fliE	Ciprofloxacin	confers no resistance to antibiotic after 18 hours
ycjN	Rifampicin	confers no resistance to antibiotic after 18 hours
nei	Gentamicin	confers no resistance to antibiotic after 18 hours
sugE	Metronidazole	confers no resistance to antibiotic after 18 hours
ydiM	Metronidazole	confers no resistance to antibiotic after 18 hours
sapA	Vancomycin	confers no resistance to antibiotic after 18 hours
lolA	Ampicillin	confers no resistance to antibiotic after 18 hours
yehI	Ampicillin	confers no resistance to antibiotic after 18 hours
phoP	Ciprofloxacin	confers no resistance to antibiotic after 18 hours
ydcK	Metronidazole	confers no resistance to antibiotic after 18 hours
yqeH	Ciprofloxacin	confers no resistance to antibiotic after 18 hours
yqhG	Vancomycin	confers no resistance to antibiotic after 18 hours
ypjJ	Metronidazole	confers no resistance to antibiotic after 18 hours
narJ	Vancomycin	confers no resistance to antibiotic after 18 hours
prfB	Metronidazole	confers no resistance to antibiotic after 18 hours
etp	Ciprofloxacin	confers no resistance to antibiotic after 18 hours
mutY	Sulfamethoxazole	confers no resistance to antibiotic after 18 hours
lpxP	Ciprofloxacin	confers no resistance to antibiotic after 18 hours
gldA	Sulfamethoxazole	confers no resistance to antibiotic after 18 hours
tabA	Rifampicin	confers no resistance to antibiotic after 18 hours
ypjM_1	Ampicillin	confers no resistance to antibiotic after 18 hours
osmC	Metronidazole	confers no resistance to antibiotic after 18 hours
ndk	Rifampicin	confers no resistance to antibiotic after 18 hours
yadC	Rifampicin	confers no resistance to antibiotic after 18 hours
wza	Gentamicin	confers no resistance to antibiotic after 18 hours
cysH	Sulfamethoxazole	confers no resistance to antibiotic after 18 hours
ybaT	Ampicillin	confers no resistance to antibiotic after 18 hours
copA	Sulfamethoxazole	confers no resistance to antibiotic after 18 hours
gntT	Gentamicin	confers no resistance to antibiotic after 18 hours
hisI	Sulfamethoxazole	confers no resistance to antibiotic after 18 hours
cmoB	Vancomycin	confers no resistance to antibiotic after 18 hours
yedX	Ampicillin	confers no resistance to antibiotic after 18 hours
yidK	Metronidazole	confers no resistance to antibiotic after 18 hours
agaB	Ciprofloxacin	confers no resistance to antibiotic after 18 hours
ybiV	Metronidazole	confers no resistance to antibiotic after 18 hours
manX	Metronidazole	confers no resistance to antibiotic after 18 hours
yhbY	Rifampicin	confers no resistance to antibiotic after 18 hours
yrfG	Gentamicin	confers no resistance to antibiotic after 18 hours
hslU	Gentamicin	confers no resistance to antibiotic after 18 hours
rffG	Vancomycin	confers no resistance to antibiotic after 18 hours
rluF	Ciprofloxacin	confers no resistance to antibiotic after 18 hours
rseB	Gentamicin	confers no resistance to antibiotic after 18 hours
yfgO	Ciprofloxacin	confers no resistance to antibiotic after 18 hours
argC	Rifampicin	confers no resistance to antibiotic after 18 hours
yihV	Vancomycin	confers no resistance to antibiotic after 18 hours
yggP	Ampicillin	confers no resistance to antibiotic after 18 hours
groL	Rifampicin	confers no resistance to antibiotic after 18 hours
cybB	Sulfamethoxazole	confers no resistance to antibiotic after 18 hours
serB	Metronidazole	confers no resistance to antibiotic after 18 hours
yjiL	Gentamicin	confers no resistance to antibiotic after 18 hours
nuoK	Vancomycin	confers no resistance to antibiotic after 18 hours
ibpB	Sulfamethoxazole	confers no resistance to antibiotic after 18 hours
yoaG	Rifampicin	confers no resistance to antibiotic after 18 hours
srlB	Ampicillin	confers no resistance to antibiotic after 18 hours
ltaE	Metronidazole	confers no resistance to antibiotic after 18 hours
rluC	Sulfamethoxazole	confers no resistance to antibiotic after 18 hours
yhbQ	Rifampicin	confers no resistance to antibiotic after 18 hours
recD	Ciprofloxacin	confers no resistance to antibiotic after 18 hours
aslA	Ampicillin	confers no resistance to antibiotic after 18 hours
yebO	Gentamicin	confers no resistance to antibiotic after 18 hours
ycjQ	Metronidazole	confers no resistance to antibiotic after 18 hours
ybcV	Ampicillin	confers no resistance to antibiotic after 18 hours
recD	Gentamicin	confers no resistance to antibiotic after 18 hours
tnaB	Rifampicin	confers no resistance to antibiotic after 18 hours
asr	Vancomycin	confers no resistance to antibiotic after 18 hours
yniA	Ampicillin	confers no resistance to antibiotic after 18 hours
rlmB	Ciprofloxacin	confers no resistance to antibiotic after 18 hours
typA	Vancomycin	confers no resistance to antibiotic after 18 hours
zraS	Ciprofloxacin	confers no resistance to antibiotic after 18 hours
sseB	Rifampicin	confers no resistance to antibiotic after 18 hours
ybaL	Sulfamethoxazole	confers no resistance to antibiotic after 18 hours
fucR	Gentamicin	confers no resistance to antibiotic after 18 hours
phoA	Rifampicin	confers no resistance to antibiotic after 18 hours
yeeL	Metronidazole	confers no resistance to antibiotic after 18 hours
tatA	Vancomycin	confers no resistance to antibiotic after 18 hours
flk	Gentamicin	confers no resistance to antibiotic after 18 hours
wcaM	Sulfamethoxazole	confers no resistance to antibiotic after 18 hours
cyoE	Sulfamethoxazole	confers no resistance to antibiotic after 18 hours
cpsB	Gentamicin	confers no resistance to antibiotic after 18 hours
ampC	Rifampicin	confers no resistance to antibiotic after 18 hours
yffB	Ciprofloxacin	confers no resistance to antibiotic after 18 hours
fruB	Rifampicin	confers no resistance to antibiotic after 18 hours
fdhD	Vancomycin	confers no resistance to antibiotic after 18 hours
wza	Sulfamethoxazole	confers no resistance to antibiotic after 18 hours
yedD	Ciprofloxacin	confers no resistance to antibiotic after 18 hours
yiiF	Rifampicin	confers no resistance to antibiotic after 18 hours
yejH	Gentamicin	confers no resistance to antibiotic after 18 hours
yojI	Sulfamethoxazole	confers no resistance to antibiotic after 18 hours
yheT	Gentamicin	confers no resistance to antibiotic after 18 hours
rraB	Rifampicin	confers no resistance to antibiotic after 18 hours
glgX	Vancomycin	confers no resistance to antibiotic after 18 hours
malZ	Ampicillin	confers no resistance to antibiotic after 18 hours
lldP	Sulfamethoxazole	confers no resistance to antibiotic after 18 hours
alpA	Ampicillin	confers no resistance to antibiotic after 18 hours
yfbR	Ampicillin	confers no resistance to antibiotic after 18 hours
nrfA	Vancomycin	confers no resistance to antibiotic after 18 hours
ynfN	Ampicillin	confers no resistance to antibiotic after 18 hours
moaE	Gentamicin	confers no resistance to antibiotic after 18 hours
kdgK	Ampicillin	confers no resistance to antibiotic after 18 hours
moaD	Vancomycin	confers no resistance to antibiotic after 18 hours
dinB	Vancomycin	confers no resistance to antibiotic after 18 hours
phnE_1	Gentamicin	confers no resistance to antibiotic after 18 hours
ndh	Gentamicin	confers no resistance to antibiotic after 18 hours
ycbB	Rifampicin	confers no resistance to antibiotic after 18 hours
yagA	Gentamicin	confers no resistance to antibiotic after 18 hours
astB	Ciprofloxacin	confers no resistance to antibiotic after 18 hours
rhaM	Vancomycin	confers no resistance to antibiotic after 18 hours
znuC	Vancomycin	confers no resistance to antibiotic after 18 hours
yacL	Ciprofloxacin	confers no resistance to antibiotic after 18 hours
ygjQ	Gentamicin	confers no resistance to antibiotic after 18 hours
fimF	Metronidazole	confers no resistance to antibiotic after 18 hours
ynbA	Gentamicin	confers no resistance to antibiotic after 18 hours
ccmC	Gentamicin	confers no resistance to antibiotic after 18 hours
yfbU	Ampicillin	confers no resistance to antibiotic after 18 hours
cyoC	Rifampicin	confers no resistance to antibiotic after 18 hours
glpX	Gentamicin	confers no resistance to antibiotic after 18 hours
casD	Ampicillin	confers no resistance to antibiotic after 18 hours
yjhI	Vancomycin	confers no resistance to antibiotic after 18 hours
tolA	Rifampicin	confers no resistance to antibiotic after 18 hours
trpR	Metronidazole	confers no resistance to antibiotic after 18 hours
srlE	Metronidazole	confers no resistance to antibiotic after 18 hours
frsA	Gentamicin	confers no resistance to antibiotic after 18 hours
purD	Ampicillin	confers no resistance to antibiotic after 18 hours
nirC	Metronidazole	confers no resistance to antibiotic after 18 hours
yjeM	Ciprofloxacin	confers no resistance to antibiotic after 18 hours
ycfP	Rifampicin	confers no resistance to antibiotic after 18 hours
umuD	Ciprofloxacin	confers no resistance to antibiotic after 18 hours
yaiY	Ciprofloxacin	confers no resistance to antibiotic after 18 hours
ycbU	Metronidazole	confers no resistance to antibiotic after 18 hours
glcC	Ampicillin	confers no resistance to antibiotic after 18 hours
cpdA	Rifampicin	confers no resistance to antibiotic after 18 hours
fadD	Gentamicin	confers no resistance to antibiotic after 18 hours
proX	Metronidazole	confers no resistance to antibiotic after 18 hours
atoA	Gentamicin	confers no resistance to antibiotic after 18 hours
yaiS	Vancomycin	confers no resistance to antibiotic after 18 hours
ygiV	Vancomycin	confers no resistance to antibiotic after 18 hours
glcF	Gentamicin	confers no resistance to antibiotic after 18 hours
ygeA	Ciprofloxacin	confers no resistance to antibiotic after 18 hours
eamA	Ciprofloxacin	confers no resistance to antibiotic after 18 hours
hchA	Ciprofloxacin	confers no resistance to antibiotic after 18 hours
manA	Rifampicin	confers no resistance to antibiotic after 18 hours
gpmA	Rifampicin	confers no resistance to antibiotic after 18 hours
puuA	Sulfamethoxazole	confers no resistance to antibiotic after 18 hours
argC	Sulfamethoxazole	confers no resistance to antibiotic after 18 hours
ybgD	Ampicillin	confers no resistance to antibiotic after 18 hours
dedA	Metronidazole	confers no resistance to antibiotic after 18 hours
glmM	Ampicillin	confers no resistance to antibiotic after 18 hours
glnQ	Ciprofloxacin	confers no resistance to antibiotic after 18 hours
dgoD	Vancomycin	confers no resistance to antibiotic after 18 hours
ydcF	Vancomycin	confers no resistance to antibiotic after 18 hours
yaiO	Sulfamethoxazole	confers no resistance to antibiotic after 18 hours
mrr	Rifampicin	confers no resistance to antibiotic after 18 hours
garR	Gentamicin	confers no resistance to antibiotic after 18 hours
mmuP	Gentamicin	confers no resistance to antibiotic after 18 hours
citC	Ampicillin	confers no resistance to antibiotic after 18 hours
fxsA	Ciprofloxacin	confers no resistance to antibiotic after 18 hours
yfhG	Gentamicin	confers no resistance to antibiotic after 18 hours
tatA	Ciprofloxacin	confers no resistance to antibiotic after 18 hours
torZ	Rifampicin	confers no resistance to antibiotic after 18 hours
yfjR	Rifampicin	confers no resistance to antibiotic after 18 hours
yibA	Ciprofloxacin	confers no resistance to antibiotic after 18 hours
purD	Metronidazole	confers no resistance to antibiotic after 18 hours
psiE	Metronidazole	confers no resistance to antibiotic after 18 hours
fepD	Vancomycin	confers no resistance to antibiotic after 18 hours
yedP	Vancomycin	confers no resistance to antibiotic after 18 hours
phnF	Ciprofloxacin	confers no resistance to antibiotic after 18 hours
greA	Rifampicin	confers no resistance to antibiotic after 18 hours
metI	Metronidazole	confers no resistance to antibiotic after 18 hours
sfmD	Metronidazole	confers no resistance to antibiotic after 18 hours
pyrL	Ciprofloxacin	confers no resistance to antibiotic after 18 hours
ydiS	Sulfamethoxazole	confers no resistance to antibiotic after 18 hours
yiiF	Vancomycin	confers no resistance to antibiotic after 18 hours
queF	Sulfamethoxazole	confers no resistance to antibiotic after 18 hours
ypdI	Ciprofloxacin	confers no resistance to antibiotic after 18 hours
nac	Gentamicin	confers no resistance to antibiotic after 18 hours
metC	Rifampicin	confers no resistance to antibiotic after 18 hours
atoB	Metronidazole	confers no resistance to antibiotic after 18 hours
melR	Ampicillin	confers no resistance to antibiotic after 18 hours
yohO	Metronidazole	confers no resistance to antibiotic after 18 hours
hypE	Ciprofloxacin	confers no resistance to antibiotic after 18 hours
smrB	Sulfamethoxazole	confers no resistance to antibiotic after 18 hours
iaaA	Gentamicin	confers no resistance to antibiotic after 18 hours
dmsB	Sulfamethoxazole	confers no resistance to antibiotic after 18 hours
malZ	Ciprofloxacin	confers no resistance to antibiotic after 18 hours
fur	Ampicillin	confers no resistance to antibiotic after 18 hours
napD	Rifampicin	confers no resistance to antibiotic after 18 hours
ybhA	Ciprofloxacin	confers no resistance to antibiotic after 18 hours
recX	Vancomycin	confers no resistance to antibiotic after 18 hours
stpA	Rifampicin	confers no resistance to antibiotic after 18 hours
kdpE	Ampicillin	confers no resistance to antibiotic after 18 hours
rimP	Ciprofloxacin	confers no resistance to antibiotic after 18 hours
pyrI	Metronidazole	confers no resistance to antibiotic after 18 hours
citE	Vancomycin	confers no resistance to antibiotic after 18 hours
ybcL	Rifampicin	confers no resistance to antibiotic after 18 hours
panE	Ampicillin	confers no resistance to antibiotic after 18 hours
ycbB	Sulfamethoxazole	confers no resistance to antibiotic after 18 hours
mhpC	Ciprofloxacin	confers no resistance to antibiotic after 18 hours
tolC	Rifampicin	confers no resistance to antibiotic after 18 hours
ypdI	Metronidazole	confers no resistance to antibiotic after 18 hours
mqsR	Ciprofloxacin	confers no resistance to antibiotic after 18 hours
ynjE	Ampicillin	confers no resistance to antibiotic after 18 hours
ygeA	Rifampicin	confers no resistance to antibiotic after 18 hours
paaE	Vancomycin	confers no resistance to antibiotic after 18 hours
ycbB	Ampicillin	confers no resistance to antibiotic after 18 hours
folM	Rifampicin	confers no resistance to antibiotic after 18 hours
sodB	Gentamicin	confers no resistance to antibiotic after 18 hours
purE	Metronidazole	confers no resistance to antibiotic after 18 hours
dctA	Vancomycin	confers no resistance to antibiotic after 18 hours
ybdZ	Sulfamethoxazole	confers no resistance to antibiotic after 18 hours
rlmC	Vancomycin	confers no resistance to antibiotic after 18 hours
yjjB	Vancomycin	confers no resistance to antibiotic after 18 hours
rhsC	Rifampicin	confers no resistance to antibiotic after 18 hours
ynfL	Ciprofloxacin	confers no resistance to antibiotic after 18 hours
livM	Rifampicin	confers no resistance to antibiotic after 18 hours
yoeE	Gentamicin	confers no resistance to antibiotic after 18 hours
speC	Gentamicin	confers no resistance to antibiotic after 18 hours
nhaA	Rifampicin	confers no resistance to antibiotic after 18 hours
pnuC	Sulfamethoxazole	confers no resistance to antibiotic after 18 hours
gspG	Gentamicin	confers no resistance to antibiotic after 18 hours
galP	Metronidazole	confers no resistance to antibiotic after 18 hours
iscA	Sulfamethoxazole	confers no resistance to antibiotic after 18 hours
crl	Vancomycin	confers no resistance to antibiotic after 18 hours
appB	Sulfamethoxazole	confers no resistance to antibiotic after 18 hours
speE	Sulfamethoxazole	confers no resistance to antibiotic after 18 hours
rtcB	Sulfamethoxazole	confers no resistance to antibiotic after 18 hours
ydfR	Sulfamethoxazole	confers no resistance to antibiotic after 18 hours
ypdC	Metronidazole	confers no resistance to antibiotic after 18 hours
rbsR	Sulfamethoxazole	confers no resistance to antibiotic after 18 hours
ypjM_3	Sulfamethoxazole	confers no resistance to antibiotic after 18 hours
allR	Gentamicin	confers no resistance to antibiotic after 18 hours
ycbF	Ampicillin	confers no resistance to antibiotic after 18 hours
yjeJ	Ampicillin	confers no resistance to antibiotic after 18 hours
hyaF	Rifampicin	confers no resistance to antibiotic after 18 hours
rusA	Sulfamethoxazole	confers no resistance to antibiotic after 18 hours
mepM	Ciprofloxacin	confers no resistance to antibiotic after 18 hours
emrK	Sulfamethoxazole	confers no resistance to antibiotic after 18 hours
pgpC	Gentamicin	confers no resistance to antibiotic after 18 hours
ptsA	Gentamicin	confers no resistance to antibiotic after 18 hours
glvC	Vancomycin	confers no resistance to antibiotic after 18 hours
ydhQ	Rifampicin	confers no resistance to antibiotic after 18 hours
renD	Sulfamethoxazole	confers no resistance to antibiotic after 18 hours
mcrA	Metronidazole	confers no resistance to antibiotic after 18 hours
ugpQ	Ampicillin	confers no resistance to antibiotic after 18 hours
ydiE	Vancomycin	confers no resistance to antibiotic after 18 hours
wcaD	Rifampicin	confers no resistance to antibiotic after 18 hours
yehP	Metronidazole	confers no resistance to antibiotic after 18 hours
yciS	Rifampicin	confers no resistance to antibiotic after 18 hours
oppB	Sulfamethoxazole	confers no resistance to antibiotic after 18 hours
puuA	Ciprofloxacin	confers no resistance to antibiotic after 18 hours
yneG	Sulfamethoxazole	confers no resistance to antibiotic after 18 hours
eutG	Gentamicin	confers no resistance to antibiotic after 18 hours
ydgA	Vancomycin	confers no resistance to antibiotic after 18 hours
dmlA	Gentamicin	confers no resistance to antibiotic after 18 hours
hisF	Vancomycin	confers no resistance to antibiotic after 18 hours
speA	Ampicillin	confers no resistance to antibiotic after 18 hours
metR	Rifampicin	confers no resistance to antibiotic after 18 hours
corA	Gentamicin	confers no resistance to antibiotic after 18 hours
agaD	Ciprofloxacin	confers no resistance to antibiotic after 18 hours
hicA	Ampicillin	confers no resistance to antibiotic after 18 hours
gcl	Rifampicin	confers no resistance to antibiotic after 18 hours
frmR	Sulfamethoxazole	confers no resistance to antibiotic after 18 hours
ycgH	Vancomycin	confers no resistance to antibiotic after 18 hours
mutT	Vancomycin	confers no resistance to antibiotic after 18 hours
cysN	Ampicillin	confers no resistance to antibiotic after 18 hours
rplK	Ciprofloxacin	confers no resistance to antibiotic after 18 hours
ygjK	Gentamicin	confers no resistance to antibiotic after 18 hours
ydhU	Gentamicin	confers no resistance to antibiotic after 18 hours
ycjF	Ampicillin	confers no resistance to antibiotic after 18 hours
cdd	Sulfamethoxazole	confers no resistance to antibiotic after 18 hours
etk	Metronidazole	confers no resistance to antibiotic after 18 hours
murQ	Rifampicin	confers no resistance to antibiotic after 18 hours
hybC	Ciprofloxacin	confers no resistance to antibiotic after 18 hours
patA	Rifampicin	confers no resistance to antibiotic after 18 hours
ydfP	Rifampicin	confers no resistance to antibiotic after 18 hours
elaD	Vancomycin	confers resistance to antibiotic after 18 hours
glyS	Ampicillin	confers no resistance to antibiotic after 18 hours
greA	Gentamicin	confers no resistance to antibiotic after 18 hours
mhpB	Ciprofloxacin	confers no resistance to antibiotic after 18 hours
ybcO	Sulfamethoxazole	confers no resistance to antibiotic after 18 hours
ycjP	Gentamicin	confers no resistance to antibiotic after 18 hours
hscA	Rifampicin	confers no resistance to antibiotic after 18 hours
cysE	Vancomycin	confers no resistance to antibiotic after 18 hours
araJ	Ampicillin	confers no resistance to antibiotic after 18 hours
fucP	Vancomycin	confers no resistance to antibiotic after 18 hours
intS	Rifampicin	confers no resistance to antibiotic after 18 hours
pabB	Vancomycin	confers no resistance to antibiotic after 18 hours
yddL	Vancomycin	confers no resistance to antibiotic after 18 hours
serA	Metronidazole	confers no resistance to antibiotic after 18 hours
dkgB	Vancomycin	confers no resistance to antibiotic after 18 hours
ypaA	Vancomycin	confers no resistance to antibiotic after 18 hours
rplY	Sulfamethoxazole	confers no resistance to antibiotic after 18 hours
yieP	Vancomycin	confers no resistance to antibiotic after 18 hours
ddpC	Ciprofloxacin	confers no resistance to antibiotic after 18 hours
yecS	Gentamicin	confers no resistance to antibiotic after 18 hours
yeiE	Ciprofloxacin	confers no resistance to antibiotic after 18 hours
galT	Vancomycin	confers no resistance to antibiotic after 18 hours
treC	Sulfamethoxazole	confers no resistance to antibiotic after 18 hours
manX	Gentamicin	confers no resistance to antibiotic after 18 hours
yiiX	Sulfamethoxazole	confers no resistance to antibiotic after 18 hours
tsr	Rifampicin	confers no resistance to antibiotic after 18 hours
mdoC	Metronidazole	confers no resistance to antibiotic after 18 hours
ycfK	Vancomycin	confers no resistance to antibiotic after 18 hours
acrD	Sulfamethoxazole	confers no resistance to antibiotic after 18 hours
qseB	Vancomycin	confers no resistance to antibiotic after 18 hours
yjjJ	Metronidazole	confers no resistance to antibiotic after 18 hours
rlmJ	Ciprofloxacin	confers no resistance to antibiotic after 18 hours
yecM	Metronidazole	confers no resistance to antibiotic after 18 hours
agaS	Gentamicin	confers no resistance to antibiotic after 18 hours
ubiH	Gentamicin	confers no resistance to antibiotic after 18 hours
fdhF	Ciprofloxacin	confers no resistance to antibiotic after 18 hours
yjjZ	Metronidazole	confers no resistance to antibiotic after 18 hours
allA	Ampicillin	confers no resistance to antibiotic after 18 hours
yebY	Ampicillin	confers no resistance to antibiotic after 18 hours
phnN	Metronidazole	confers no resistance to antibiotic after 18 hours
yehR	Ampicillin	confers no resistance to antibiotic after 18 hours
clcA	Sulfamethoxazole	confers no resistance to antibiotic after 18 hours
djlC	Vancomycin	confers no resistance to antibiotic after 18 hours
mazF	Sulfamethoxazole	confers no resistance to antibiotic after 18 hours
malS	Ampicillin	confers no resistance to antibiotic after 18 hours
entS	Ampicillin	confers no resistance to antibiotic after 18 hours
nlpD	Gentamicin	confers no resistance to antibiotic after 18 hours
ytfL	Vancomycin	confers no resistance to antibiotic after 18 hours
kdgT	Metronidazole	confers no resistance to antibiotic after 18 hours
ymfR	Sulfamethoxazole	confers no resistance to antibiotic after 18 hours
fimA	Metronidazole	confers no resistance to antibiotic after 18 hours
mglC	Ciprofloxacin	confers no resistance to antibiotic after 18 hours
fhuF	Sulfamethoxazole	confers no resistance to antibiotic after 18 hours
pbpC	Sulfamethoxazole	confers no resistance to antibiotic after 18 hours
ptsG	Ciprofloxacin	confers no resistance to antibiotic after 18 hours
yqgA	Metronidazole	confers no resistance to antibiotic after 18 hours
yqiB	Gentamicin	confers no resistance to antibiotic after 18 hours
yfjZ	Rifampicin	confers no resistance to antibiotic after 18 hours
nfuA	Ampicillin	confers no resistance to antibiotic after 18 hours
aroC	Ampicillin	confers no resistance to antibiotic after 18 hours
betT	Rifampicin	confers no resistance to antibiotic after 18 hours
pepN	Gentamicin	confers no resistance to antibiotic after 18 hours
aphA	Vancomycin	confers no resistance to antibiotic after 18 hours
eutC	Rifampicin	confers no resistance to antibiotic after 18 hours
yegD	Sulfamethoxazole	confers no resistance to antibiotic after 18 hours
setC	Sulfamethoxazole	confers no resistance to antibiotic after 18 hours
yjaZ	Rifampicin	confers no resistance to antibiotic after 18 hours
gadE	Ampicillin	confers no resistance to antibiotic after 18 hours
yeaC	Rifampicin	confers no resistance to antibiotic after 18 hours
minC	Metronidazole	confers no resistance to antibiotic after 18 hours
kduI	Sulfamethoxazole	confers no resistance to antibiotic after 18 hours
lon	Ciprofloxacin	confers no resistance to antibiotic after 18 hours
dedD	Rifampicin	confers no resistance to antibiotic after 18 hours
srlE	Ciprofloxacin	confers no resistance to antibiotic after 18 hours
yajI	Ampicillin	confers no resistance to antibiotic after 18 hours
sucA	Sulfamethoxazole	confers no resistance to antibiotic after 18 hours
higB	Vancomycin	confers no resistance to antibiotic after 18 hours
yjeH	Gentamicin	confers no resistance to antibiotic after 18 hours
motA	Rifampicin	confers no resistance to antibiotic after 18 hours
oppF	Vancomycin	confers no resistance to antibiotic after 18 hours
ycbV	Ciprofloxacin	confers no resistance to antibiotic after 18 hours
ybaO	Metronidazole	confers no resistance to antibiotic after 18 hours
yahO	Ampicillin	confers no resistance to antibiotic after 18 hours
ydcH	Ampicillin	confers no resistance to antibiotic after 18 hours
yhcA	Sulfamethoxazole	confers no resistance to antibiotic after 18 hours
cmoB	Rifampicin	confers no resistance to antibiotic after 18 hours
csgF	Metronidazole	confers no resistance to antibiotic after 18 hours
yfbT	Ampicillin	confers no resistance to antibiotic after 18 hours
lsrR	Ciprofloxacin	confers no resistance to antibiotic after 18 hours
ydcJ	Sulfamethoxazole	confers no resistance to antibiotic after 18 hours
yhiD	Metronidazole	confers no resistance to antibiotic after 18 hours
ydiN	Rifampicin	confers no resistance to antibiotic after 18 hours
yedZ	Ampicillin	confers no resistance to antibiotic after 18 hours
bcp	Ciprofloxacin	confers no resistance to antibiotic after 18 hours
fadD	Ciprofloxacin	confers no resistance to antibiotic after 18 hours
rfaE	Ampicillin	confers no resistance to antibiotic after 18 hours
gspE	Vancomycin	confers no resistance to antibiotic after 18 hours
phnK	Vancomycin	confers no resistance to antibiotic after 18 hours
ynjC	Sulfamethoxazole	confers no resistance to antibiotic after 18 hours
feoA	Vancomycin	confers no resistance to antibiotic after 18 hours
dmsA	Rifampicin	confers no resistance to antibiotic after 18 hours
ilvD	Sulfamethoxazole	confers no resistance to antibiotic after 18 hours
yecS	Ampicillin	confers no resistance to antibiotic after 18 hours
yecT	Rifampicin	confers no resistance to antibiotic after 18 hours
fldB	Gentamicin	confers no resistance to antibiotic after 18 hours
yqjA	Ampicillin	confers no resistance to antibiotic after 18 hours
yfdQ	Metronidazole	confers no resistance to antibiotic after 18 hours
poxB	Ciprofloxacin	confers no resistance to antibiotic after 18 hours
cas3	Ciprofloxacin	confers no resistance to antibiotic after 18 hours
elbB	Sulfamethoxazole	confers no resistance to antibiotic after 18 hours
yfdS	Metronidazole	confers no resistance to antibiotic after 18 hours
cpsB	Ciprofloxacin	confers no resistance to antibiotic after 18 hours
yeiH	Vancomycin	confers no resistance to antibiotic after 18 hours
atoE	Ampicillin	confers no resistance to antibiotic after 18 hours
yfjY	Ciprofloxacin	confers no resistance to antibiotic after 18 hours
ydjK	Ampicillin	confers no resistance to antibiotic after 18 hours
ecnA	Rifampicin	confers no resistance to antibiotic after 18 hours
dcm	Vancomycin	confers no resistance to antibiotic after 18 hours
mqsR	Metronidazole	confers no resistance to antibiotic after 18 hours
ydjX	Ampicillin	confers no resistance to antibiotic after 18 hours
yhgN	Ciprofloxacin	confers no resistance to antibiotic after 18 hours
waaS	Metronidazole	confers no resistance to antibiotic after 18 hours
mlrA	Gentamicin	confers no resistance to antibiotic after 18 hours
feoB	Ampicillin	confers no resistance to antibiotic after 18 hours
yihV	Ciprofloxacin	confers no resistance to antibiotic after 18 hours
slyD	Sulfamethoxazole	confers no resistance to antibiotic after 18 hours
yqfA	Gentamicin	confers no resistance to antibiotic after 18 hours
ybiV	Gentamicin	confers no resistance to antibiotic after 18 hours
rlmF	Gentamicin	confers no resistance to antibiotic after 18 hours
treR	Gentamicin	confers no resistance to antibiotic after 18 hours
fhuA	Metronidazole	confers no resistance to antibiotic after 18 hours
atoS	Metronidazole	confers no resistance to antibiotic after 18 hours
mhpF	Sulfamethoxazole	confers no resistance to antibiotic after 18 hours
typA	Rifampicin	confers no resistance to antibiotic after 18 hours
aceB	Rifampicin	confers no resistance to antibiotic after 18 hours
yadI	Rifampicin	confers no resistance to antibiotic after 18 hours
casD	Gentamicin	confers no resistance to antibiotic after 18 hours
paaJ	Gentamicin	confers no resistance to antibiotic after 18 hours
mhpB	Sulfamethoxazole	confers no resistance to antibiotic after 18 hours
gldA	Gentamicin	confers no resistance to antibiotic after 18 hours
yhhT	Ciprofloxacin	confers no resistance to antibiotic after 18 hours
yhiS	Ampicillin	confers no resistance to antibiotic after 18 hours
acrZ	Ampicillin	confers resistance to antibiotic after 18 hours
folB	Sulfamethoxazole	confers no resistance to antibiotic after 18 hours
yjhX	Metronidazole	confers no resistance to antibiotic after 18 hours
cydB	Ciprofloxacin	confers no resistance to antibiotic after 18 hours
ygaH	Rifampicin	confers no resistance to antibiotic after 18 hours
ycaM	Metronidazole	confers no resistance to antibiotic after 18 hours
yfjU	Vancomycin	confers no resistance to antibiotic after 18 hours
casD	Metronidazole	confers no resistance to antibiotic after 18 hours
yfjT	Metronidazole	confers no resistance to antibiotic after 18 hours
yibF	Rifampicin	confers no resistance to antibiotic after 18 hours
ydhV	Vancomycin	confers no resistance to antibiotic after 18 hours
ybgK	Ciprofloxacin	confers no resistance to antibiotic after 18 hours
aer	Metronidazole	confers no resistance to antibiotic after 18 hours
tdcC	Ciprofloxacin	confers no resistance to antibiotic after 18 hours
yjiR	Metronidazole	confers no resistance to antibiotic after 18 hours
fryA	Rifampicin	confers no resistance to antibiotic after 18 hours
mdtA	Ciprofloxacin	confers no resistance to antibiotic after 18 hours
hyaB	Metronidazole	confers no resistance to antibiotic after 18 hours
gcvR	Ciprofloxacin	confers no resistance to antibiotic after 18 hours
yqcC	Sulfamethoxazole	confers no resistance to antibiotic after 18 hours
pntA	Ciprofloxacin	confers no resistance to antibiotic after 18 hours
gspL	Metronidazole	confers no resistance to antibiotic after 18 hours
yciM	Vancomycin	confers resistance to antibiotic after 18 hours
amyA	Ciprofloxacin	confers no resistance to antibiotic after 18 hours
rsd	Metronidazole	confers no resistance to antibiotic after 18 hours
yjeH	Ciprofloxacin	confers no resistance to antibiotic after 18 hours
ycfH	Sulfamethoxazole	confers no resistance to antibiotic after 18 hours
dacB	Gentamicin	confers no resistance to antibiotic after 18 hours
tatD	Ciprofloxacin	confers no resistance to antibiotic after 18 hours
yahG	Ampicillin	confers no resistance to antibiotic after 18 hours
hycC	Ampicillin	confers no resistance to antibiotic after 18 hours
mglB	Gentamicin	confers no resistance to antibiotic after 18 hours
nlpA	Metronidazole	confers no resistance to antibiotic after 18 hours
uvrD	Ampicillin	confers no resistance to antibiotic after 18 hours
yjcD	Rifampicin	confers no resistance to antibiotic after 18 hours
ybfQ	Vancomycin	confers no resistance to antibiotic after 18 hours
wcaL	Rifampicin	confers no resistance to antibiotic after 18 hours
sieB	Rifampicin	confers no resistance to antibiotic after 18 hours
ylbE	Sulfamethoxazole	confers no resistance to antibiotic after 18 hours
rpiA	Rifampicin	confers no resistance to antibiotic after 18 hours
yfeK	Sulfamethoxazole	confers no resistance to antibiotic after 18 hours
yigI	Sulfamethoxazole	confers no resistance to antibiotic after 18 hours
pykA	Sulfamethoxazole	confers no resistance to antibiotic after 18 hours
yncD	Vancomycin	confers no resistance to antibiotic after 18 hours
djlC	Ampicillin	confers no resistance to antibiotic after 18 hours
manZ	Metronidazole	confers no resistance to antibiotic after 18 hours
yohO	Ciprofloxacin	confers no resistance to antibiotic after 18 hours
kdgT	Ciprofloxacin	confers no resistance to antibiotic after 18 hours
yjdI	Gentamicin	confers no resistance to antibiotic after 18 hours
recX	Metronidazole	confers no resistance to antibiotic after 18 hours
trmA	Vancomycin	confers no resistance to antibiotic after 18 hours
nemA	Ciprofloxacin	confers no resistance to antibiotic after 18 hours
pcnB	Metronidazole	confers no resistance to antibiotic after 18 hours
yoeF	Metronidazole	confers no resistance to antibiotic after 18 hours
brnQ	Rifampicin	confers no resistance to antibiotic after 18 hours
clsB	Gentamicin	confers no resistance to antibiotic after 18 hours
hslR	Rifampicin	confers no resistance to antibiotic after 18 hours
yfcA	Metronidazole	confers no resistance to antibiotic after 18 hours
pbl	Gentamicin	confers no resistance to antibiotic after 18 hours
ybjN	Ampicillin	confers no resistance to antibiotic after 18 hours
ydaN	Rifampicin	confers no resistance to antibiotic after 18 hours
tusC	Ampicillin	confers no resistance to antibiotic after 18 hours
yhdP	Sulfamethoxazole	confers no resistance to antibiotic after 18 hours
cysW	Vancomycin	confers no resistance to antibiotic after 18 hours
hycI	Vancomycin	confers no resistance to antibiotic after 18 hours
tonB	Ciprofloxacin	confers no resistance to antibiotic after 18 hours
flgI	Metronidazole	confers no resistance to antibiotic after 18 hours
fsaA	Vancomycin	confers no resistance to antibiotic after 18 hours
atoD	Metronidazole	confers no resistance to antibiotic after 18 hours
rsmD	Rifampicin	confers no resistance to antibiotic after 18 hours
wcaB	Ampicillin	confers no resistance to antibiotic after 18 hours
glpG	Metronidazole	confers no resistance to antibiotic after 18 hours
yjjA	Vancomycin	confers no resistance to antibiotic after 18 hours
yhfZ	Gentamicin	confers no resistance to antibiotic after 18 hours
rnd	Vancomycin	confers no resistance to antibiotic after 18 hours
sfmD	Rifampicin	confers no resistance to antibiotic after 18 hours
speA	Metronidazole	confers no resistance to antibiotic after 18 hours
rbbA	Ciprofloxacin	confers no resistance to antibiotic after 18 hours
abgT	Ciprofloxacin	confers no resistance to antibiotic after 18 hours
yneK	Gentamicin	confers no resistance to antibiotic after 18 hours
yhiD	Rifampicin	confers no resistance to antibiotic after 18 hours
ilvH	Vancomycin	confers no resistance to antibiotic after 18 hours
gltP	Ampicillin	confers no resistance to antibiotic after 18 hours
yccA	Gentamicin	confers no resistance to antibiotic after 18 hours
yjdK	Metronidazole	confers no resistance to antibiotic after 18 hours
yjiG	Rifampicin	confers no resistance to antibiotic after 18 hours
ydjN	Metronidazole	confers no resistance to antibiotic after 18 hours
yddL	Rifampicin	confers no resistance to antibiotic after 18 hours
yjhE	Ciprofloxacin	confers no resistance to antibiotic after 18 hours
guaA	Ciprofloxacin	confers no resistance to antibiotic after 18 hours
yfcF	Gentamicin	confers no resistance to antibiotic after 18 hours
rfaE	Rifampicin	confers resistance to antibiotic after 18 hours
gatB	Ciprofloxacin	confers no resistance to antibiotic after 18 hours
yiaY	Ciprofloxacin	confers no resistance to antibiotic after 18 hours
msrA	Vancomycin	confers no resistance to antibiotic after 18 hours
ylcG	Vancomycin	confers no resistance to antibiotic after 18 hours
yhjK	Ciprofloxacin	confers no resistance to antibiotic after 18 hours
fimC	Metronidazole	confers no resistance to antibiotic after 18 hours
leuD	Ciprofloxacin	confers no resistance to antibiotic after 18 hours
yhiJ	Metronidazole	confers no resistance to antibiotic after 18 hours
fbp	Metronidazole	confers no resistance to antibiotic after 18 hours
ycjS	Gentamicin	confers no resistance to antibiotic after 18 hours
rpmJ	Sulfamethoxazole	confers no resistance to antibiotic after 18 hours
ansP	Metronidazole	confers no resistance to antibiotic after 18 hours
tusB	Ciprofloxacin	confers no resistance to antibiotic after 18 hours
sodB	Ciprofloxacin	confers no resistance to antibiotic after 18 hours
ccmE	Rifampicin	confers no resistance to antibiotic after 18 hours
uxaB	Ampicillin	confers no resistance to antibiotic after 18 hours
ycbJ	Ampicillin	confers no resistance to antibiotic after 18 hours
yeiG	Rifampicin	confers no resistance to antibiotic after 18 hours
proQ	Ciprofloxacin	confers no resistance to antibiotic after 18 hours
gsiA	Vancomycin	confers no resistance to antibiotic after 18 hours
yhdW	Ampicillin	confers no resistance to antibiotic after 18 hours
cvrA	Vancomycin	confers no resistance to antibiotic after 18 hours
yicL	Metronidazole	confers no resistance to antibiotic after 18 hours
gltJ	Ampicillin	confers no resistance to antibiotic after 18 hours
ansB	Vancomycin	confers no resistance to antibiotic after 18 hours
ylbF	Metronidazole	confers no resistance to antibiotic after 18 hours
ydfV	Vancomycin	confers no resistance to antibiotic after 18 hours
ydfI	Vancomycin	confers no resistance to antibiotic after 18 hours
fbaB	Rifampicin	confers no resistance to antibiotic after 18 hours
yohF	Metronidazole	confers no resistance to antibiotic after 18 hours
yehY	Rifampicin	confers no resistance to antibiotic after 18 hours
sbp	Vancomycin	confers no resistance to antibiotic after 18 hours
ycfS	Gentamicin	confers no resistance to antibiotic after 18 hours
ypjC	Metronidazole	confers no resistance to antibiotic after 18 hours
yaaJ	Ciprofloxacin	confers no resistance to antibiotic after 18 hours
yfjW	Ciprofloxacin	confers no resistance to antibiotic after 18 hours
yhjA	Ampicillin	confers no resistance to antibiotic after 18 hours
ydaS	Sulfamethoxazole	confers no resistance to antibiotic after 18 hours
yqiC	Metronidazole	confers no resistance to antibiotic after 18 hours
ampD	Ampicillin	confers no resistance to antibiotic after 18 hours
chiP	Sulfamethoxazole	confers no resistance to antibiotic after 18 hours
ydfU	Ciprofloxacin	confers no resistance to antibiotic after 18 hours
gatB	Ampicillin	confers no resistance to antibiotic after 18 hours
cysW	Metronidazole	confers no resistance to antibiotic after 18 hours
hisA	Metronidazole	confers no resistance to antibiotic after 18 hours
yafL	Ciprofloxacin	confers no resistance to antibiotic after 18 hours
yiaY	Rifampicin	confers no resistance to antibiotic after 18 hours
putA	Sulfamethoxazole	confers no resistance to antibiotic after 18 hours
lsrG	Ciprofloxacin	confers no resistance to antibiotic after 18 hours
gadB	Sulfamethoxazole	confers no resistance to antibiotic after 18 hours
cas1	Rifampicin	confers no resistance to antibiotic after 18 hours
napB	Gentamicin	confers no resistance to antibiotic after 18 hours
yieP	Rifampicin	confers no resistance to antibiotic after 18 hours
sgbE	Rifampicin	confers no resistance to antibiotic after 18 hours
mak	Metronidazole	confers no resistance to antibiotic after 18 hours
ccmF	Ampicillin	confers no resistance to antibiotic after 18 hours
tusD	Vancomycin	confers resistance to antibiotic after 18 hours
yphG	Sulfamethoxazole	confers no resistance to antibiotic after 18 hours
yhjH	Gentamicin	confers no resistance to antibiotic after 18 hours
glpF	Sulfamethoxazole	confers no resistance to antibiotic after 18 hours
wbbJ	Rifampicin	confers no resistance to antibiotic after 18 hours
metN	Rifampicin	confers no resistance to antibiotic after 18 hours
uhpC	Ampicillin	confers no resistance to antibiotic after 18 hours
eaeH	Gentamicin	confers no resistance to antibiotic after 18 hours
yajC	Vancomycin	confers no resistance to antibiotic after 18 hours
nanS	Rifampicin	confers no resistance to antibiotic after 18 hours
zapD	Rifampicin	confers no resistance to antibiotic after 18 hours
cysE	Ciprofloxacin	confers no resistance to antibiotic after 18 hours
yghO	Ciprofloxacin	confers no resistance to antibiotic after 18 hours
yqjC	Vancomycin	confers no resistance to antibiotic after 18 hours
rluA	Rifampicin	confers no resistance to antibiotic after 18 hours
dacA	Vancomycin	confers no resistance to antibiotic after 18 hours
preA	Ciprofloxacin	confers no resistance to antibiotic after 18 hours
yagH	Ampicillin	confers no resistance to antibiotic after 18 hours
ssuA	Metronidazole	confers no resistance to antibiotic after 18 hours
ycdY	Vancomycin	confers no resistance to antibiotic after 18 hours
gadA	Sulfamethoxazole	confers no resistance to antibiotic after 18 hours
envZ	Ampicillin	confers no resistance to antibiotic after 18 hours
hslU	Rifampicin	confers no resistance to antibiotic after 18 hours
nuoG	Gentamicin	confers no resistance to antibiotic after 18 hours
ygaP	Vancomycin	confers no resistance to antibiotic after 18 hours
ybaN	Rifampicin	confers no resistance to antibiotic after 18 hours
gph	Metronidazole	confers no resistance to antibiotic after 18 hours
msrB	Ampicillin	confers no resistance to antibiotic after 18 hours
yjjK	Vancomycin	confers no resistance to antibiotic after 18 hours
mbhA	Vancomycin	confers no resistance to antibiotic after 18 hours
atpH	Vancomycin	confers no resistance to antibiotic after 18 hours
ychE	Gentamicin	confers no resistance to antibiotic after 18 hours
rpiA	Ciprofloxacin	confers no resistance to antibiotic after 18 hours
dhaM	Metronidazole	confers no resistance to antibiotic after 18 hours
yraI	Sulfamethoxazole	confers no resistance to antibiotic after 18 hours
waaB	Sulfamethoxazole	confers no resistance to antibiotic after 18 hours
yhdT	Metronidazole	confers no resistance to antibiotic after 18 hours
yedD	Metronidazole	confers no resistance to antibiotic after 18 hours
arsB	Vancomycin	confers no resistance to antibiotic after 18 hours
csgG	Ciprofloxacin	confers no resistance to antibiotic after 18 hours
atl	Rifampicin	confers no resistance to antibiotic after 18 hours
glpA	Rifampicin	confers no resistance to antibiotic after 18 hours
ycdY	Gentamicin	confers no resistance to antibiotic after 18 hours
etp	Rifampicin	confers no resistance to antibiotic after 18 hours
ynfN	Sulfamethoxazole	confers no resistance to antibiotic after 18 hours
purR	Sulfamethoxazole	confers no resistance to antibiotic after 18 hours
ynjA	Vancomycin	confers no resistance to antibiotic after 18 hours
nhaR	Gentamicin	confers no resistance to antibiotic after 18 hours
yciX	Ampicillin	confers no resistance to antibiotic after 18 hours
tatE	Sulfamethoxazole	confers no resistance to antibiotic after 18 hours
yiaN	Rifampicin	confers no resistance to antibiotic after 18 hours
sucC	Rifampicin	confers no resistance to antibiotic after 18 hours
ybhF	Metronidazole	confers no resistance to antibiotic after 18 hours
yjeM	Sulfamethoxazole	confers no resistance to antibiotic after 18 hours
yagW	Sulfamethoxazole	confers no resistance to antibiotic after 18 hours
aaeX	Ciprofloxacin	confers no resistance to antibiotic after 18 hours
rplA	Rifampicin	confers resistance to antibiotic after 18 hours
ais	Gentamicin	confers no resistance to antibiotic after 18 hours
fixC	Sulfamethoxazole	confers no resistance to antibiotic after 18 hours
acrA	Gentamicin	confers no resistance to antibiotic after 18 hours
lpd	Rifampicin	confers no resistance to antibiotic after 18 hours
astA	Vancomycin	confers no resistance to antibiotic after 18 hours
ydjZ	Vancomycin	confers no resistance to antibiotic after 18 hours
yigA	Ciprofloxacin	confers no resistance to antibiotic after 18 hours
dinF	Sulfamethoxazole	confers no resistance to antibiotic after 18 hours
ybcY	Rifampicin	confers no resistance to antibiotic after 18 hours
ygjH	Metronidazole	confers no resistance to antibiotic after 18 hours
rlmC	Gentamicin	confers no resistance to antibiotic after 18 hours
yicS	Rifampicin	confers no resistance to antibiotic after 18 hours
deoD	Gentamicin	confers no resistance to antibiotic after 18 hours
dsdA	Rifampicin	confers no resistance to antibiotic after 18 hours
yggF	Rifampicin	confers no resistance to antibiotic after 18 hours
malP	Vancomycin	confers no resistance to antibiotic after 18 hours
bcr	Metronidazole	confers no resistance to antibiotic after 18 hours
yfdC	Rifampicin	confers no resistance to antibiotic after 18 hours
yfgI	Metronidazole	confers no resistance to antibiotic after 18 hours
csgB	Vancomycin	confers no resistance to antibiotic after 18 hours
napH	Sulfamethoxazole	confers no resistance to antibiotic after 18 hours
nfrB	Vancomycin	confers no resistance to antibiotic after 18 hours
ydeS	Gentamicin	confers no resistance to antibiotic after 18 hours
ydeR	Metronidazole	confers no resistance to antibiotic after 18 hours
psiE	Vancomycin	confers no resistance to antibiotic after 18 hours
ypjM_1	Gentamicin	confers no resistance to antibiotic after 18 hours
hofM	Vancomycin	confers no resistance to antibiotic after 18 hours
ppiC	Ciprofloxacin	confers no resistance to antibiotic after 18 hours
ydeJ	Sulfamethoxazole	confers no resistance to antibiotic after 18 hours
yfiN	Ampicillin	confers no resistance to antibiotic after 18 hours
mbhA	Rifampicin	confers no resistance to antibiotic after 18 hours
ygbM	Metronidazole	confers no resistance to antibiotic after 18 hours
glcF	Ampicillin	confers no resistance to antibiotic after 18 hours
ymdA	Metronidazole	confers no resistance to antibiotic after 18 hours
slmA	Ciprofloxacin	confers no resistance to antibiotic after 18 hours
yrbL	Metronidazole	confers no resistance to antibiotic after 18 hours
fsaB	Vancomycin	confers no resistance to antibiotic after 18 hours
curA	Ampicillin	confers no resistance to antibiotic after 18 hours
sbcC	Ampicillin	confers no resistance to antibiotic after 18 hours
caiF	Metronidazole	confers no resistance to antibiotic after 18 hours
melA	Gentamicin	confers no resistance to antibiotic after 18 hours
zitB	Rifampicin	confers no resistance to antibiotic after 18 hours
yihN	Ciprofloxacin	confers no resistance to antibiotic after 18 hours
yccM	Rifampicin	confers no resistance to antibiotic after 18 hours
yhcA	Gentamicin	confers no resistance to antibiotic after 18 hours
yidJ	Gentamicin	confers no resistance to antibiotic after 18 hours
trkA	Metronidazole	confers no resistance to antibiotic after 18 hours
pagP	Metronidazole	confers no resistance to antibiotic after 18 hours
dnaJ	Gentamicin	confers no resistance to antibiotic after 18 hours
ypeA	Metronidazole	confers no resistance to antibiotic after 18 hours
yhcH	Ciprofloxacin	confers no resistance to antibiotic after 18 hours
ydfT	Ciprofloxacin	confers no resistance to antibiotic after 18 hours
leuE	Metronidazole	confers no resistance to antibiotic after 18 hours
eutT	Ciprofloxacin	confers no resistance to antibiotic after 18 hours
pgpC	Rifampicin	confers no resistance to antibiotic after 18 hours
yhjV	Sulfamethoxazole	confers no resistance to antibiotic after 18 hours
deaD	Sulfamethoxazole	confers no resistance to antibiotic after 18 hours
ppsA	Rifampicin	confers no resistance to antibiotic after 18 hours
glpR	Ampicillin	confers no resistance to antibiotic after 18 hours
cnu	Metronidazole	confers no resistance to antibiotic after 18 hours
thiP	Vancomycin	confers no resistance to antibiotic after 18 hours
yegQ	Metronidazole	confers no resistance to antibiotic after 18 hours
ecnB	Ciprofloxacin	confers no resistance to antibiotic after 18 hours
hofO	Sulfamethoxazole	confers no resistance to antibiotic after 18 hours
ygeA	Metronidazole	confers no resistance to antibiotic after 18 hours
nikB	Vancomycin	confers no resistance to antibiotic after 18 hours
fadA	Vancomycin	confers no resistance to antibiotic after 18 hours
fhuA	Vancomycin	confers no resistance to antibiotic after 18 hours
tufA	Ampicillin	confers no resistance to antibiotic after 18 hours
dhaM	Gentamicin	confers no resistance to antibiotic after 18 hours
yhfL	Ciprofloxacin	confers no resistance to antibiotic after 18 hours
ppiC	Gentamicin	confers no resistance to antibiotic after 18 hours
ydcH	Gentamicin	confers no resistance to antibiotic after 18 hours
murP	Ampicillin	confers no resistance to antibiotic after 18 hours
cytR	Sulfamethoxazole	confers no resistance to antibiotic after 18 hours
yedA	Vancomycin	confers no resistance to antibiotic after 18 hours
sanA	Ampicillin	confers no resistance to antibiotic after 18 hours
arfB	Rifampicin	confers no resistance to antibiotic after 18 hours
motB	Rifampicin	confers no resistance to antibiotic after 18 hours
frvR	Ciprofloxacin	confers no resistance to antibiotic after 18 hours
ybjD	Sulfamethoxazole	confers no resistance to antibiotic after 18 hours
ydjK	Vancomycin	confers no resistance to antibiotic after 18 hours
amn	Vancomycin	confers no resistance to antibiotic after 18 hours
ycjY	Sulfamethoxazole	confers no resistance to antibiotic after 18 hours
gudX	Ampicillin	confers no resistance to antibiotic after 18 hours
yedP	Rifampicin	confers no resistance to antibiotic after 18 hours
yfbR	Vancomycin	confers no resistance to antibiotic after 18 hours
malK	Gentamicin	confers no resistance to antibiotic after 18 hours
malX	Ampicillin	confers no resistance to antibiotic after 18 hours
ydcK	Ciprofloxacin	confers no resistance to antibiotic after 18 hours
dcuR	Metronidazole	confers no resistance to antibiotic after 18 hours
yrhA	Gentamicin	confers no resistance to antibiotic after 18 hours
ileS	Sulfamethoxazole	confers no resistance to antibiotic after 18 hours
yhcB	Gentamicin	confers no resistance to antibiotic after 18 hours
yceO	Vancomycin	confers no resistance to antibiotic after 18 hours
yeaW	Metronidazole	confers no resistance to antibiotic after 18 hours
tam	Ampicillin	confers no resistance to antibiotic after 18 hours
folX	Vancomycin	confers no resistance to antibiotic after 18 hours
yifO	Vancomycin	confers no resistance to antibiotic after 18 hours
yhhM	Vancomycin	confers no resistance to antibiotic after 18 hours
ybiA	Ciprofloxacin	confers no resistance to antibiotic after 18 hours
hflC	Gentamicin	confers no resistance to antibiotic after 18 hours
yjhG	Rifampicin	confers no resistance to antibiotic after 18 hours
rpmG	Metronidazole	confers no resistance to antibiotic after 18 hours
ybcM	Ampicillin	confers no resistance to antibiotic after 18 hours
rhsA	Gentamicin	confers no resistance to antibiotic after 18 hours
feoA	Gentamicin	confers no resistance to antibiotic after 18 hours
panF	Gentamicin	confers no resistance to antibiotic after 18 hours
zwf	Sulfamethoxazole	confers no resistance to antibiotic after 18 hours
pepN	Rifampicin	confers no resistance to antibiotic after 18 hours
ymjA	Ampicillin	confers no resistance to antibiotic after 18 hours
yhjR	Gentamicin	confers no resistance to antibiotic after 18 hours
yeiH	Gentamicin	confers no resistance to antibiotic after 18 hours
citF	Sulfamethoxazole	confers no resistance to antibiotic after 18 hours
yjcF	Vancomycin	confers no resistance to antibiotic after 18 hours
yejE	Ampicillin	confers no resistance to antibiotic after 18 hours
clpS	Vancomycin	confers no resistance to antibiotic after 18 hours
yggC	Rifampicin	confers no resistance to antibiotic after 18 hours
ycfP	Gentamicin	confers no resistance to antibiotic after 18 hours
ptsA	Rifampicin	confers no resistance to antibiotic after 18 hours
agaD	Sulfamethoxazole	confers no resistance to antibiotic after 18 hours
yajQ	Ciprofloxacin	confers no resistance to antibiotic after 18 hours
elaA	Gentamicin	confers no resistance to antibiotic after 18 hours
asnC	Ciprofloxacin	confers no resistance to antibiotic after 18 hours
ydjF	Ampicillin	confers no resistance to antibiotic after 18 hours
cydB	Vancomycin	confers no resistance to antibiotic after 18 hours
ymdB	Sulfamethoxazole	confers no resistance to antibiotic after 18 hours
yghG	Metronidazole	confers no resistance to antibiotic after 18 hours
waaB	Metronidazole	confers no resistance to antibiotic after 18 hours
sgbU	Ciprofloxacin	confers no resistance to antibiotic after 18 hours
gltD	Sulfamethoxazole	confers no resistance to antibiotic after 18 hours
mntR	Gentamicin	confers no resistance to antibiotic after 18 hours
atpA	Gentamicin	confers no resistance to antibiotic after 18 hours
tsgA	Ampicillin	confers no resistance to antibiotic after 18 hours
rzpR	Ampicillin	confers no resistance to antibiotic after 18 hours
ycjR	Ampicillin	confers no resistance to antibiotic after 18 hours
yjfI	Vancomycin	confers no resistance to antibiotic after 18 hours
yggW	Sulfamethoxazole	confers no resistance to antibiotic after 18 hours
fkpB	Sulfamethoxazole	confers no resistance to antibiotic after 18 hours
yhdJ	Rifampicin	confers no resistance to antibiotic after 18 hours
kbaZ	Metronidazole	confers no resistance to antibiotic after 18 hours
cueO	Metronidazole	confers no resistance to antibiotic after 18 hours
agaI	Gentamicin	confers no resistance to antibiotic after 18 hours
gspM	Gentamicin	confers no resistance to antibiotic after 18 hours
envY	Ciprofloxacin	confers no resistance to antibiotic after 18 hours
yjbM	Vancomycin	confers no resistance to antibiotic after 18 hours
cysG	Ampicillin	confers no resistance to antibiotic after 18 hours
casE	Sulfamethoxazole	confers no resistance to antibiotic after 18 hours
fucK	Gentamicin	confers no resistance to antibiotic after 18 hours
fimB	Metronidazole	confers no resistance to antibiotic after 18 hours
tdcC	Vancomycin	confers no resistance to antibiotic after 18 hours
yciQ	Vancomycin	confers no resistance to antibiotic after 18 hours
argB	Ampicillin	confers no resistance to antibiotic after 18 hours
agaI	Sulfamethoxazole	confers no resistance to antibiotic after 18 hours
ykgA	Sulfamethoxazole	confers no resistance to antibiotic after 18 hours
waaJ	Metronidazole	confers no resistance to antibiotic after 18 hours
yceA	Gentamicin	confers no resistance to antibiotic after 18 hours
grxC	Ciprofloxacin	confers no resistance to antibiotic after 18 hours
dppA	Vancomycin	confers no resistance to antibiotic after 18 hours
rnhB	Sulfamethoxazole	confers no resistance to antibiotic after 18 hours
eutH	Gentamicin	confers no resistance to antibiotic after 18 hours
phnD	Rifampicin	confers no resistance to antibiotic after 18 hours
yrbL	Sulfamethoxazole	confers no resistance to antibiotic after 18 hours
elfC	Metronidazole	confers no resistance to antibiotic after 18 hours
pliG	Sulfamethoxazole	confers no resistance to antibiotic after 18 hours
yqaB	Sulfamethoxazole	confers no resistance to antibiotic after 18 hours
alaT	Vancomycin	confers no resistance to antibiotic after 18 hours
sbmC	Sulfamethoxazole	confers no resistance to antibiotic after 18 hours
yahG	Ciprofloxacin	confers no resistance to antibiotic after 18 hours
yobD	Ciprofloxacin	confers no resistance to antibiotic after 18 hours
yjfY	Ampicillin	confers no resistance to antibiotic after 18 hours
ybfO	Ciprofloxacin	confers no resistance to antibiotic after 18 hours
nudC	Vancomycin	confers no resistance to antibiotic after 18 hours
yggM	Ciprofloxacin	confers no resistance to antibiotic after 18 hours
phoB	Ampicillin	confers no resistance to antibiotic after 18 hours
intB	Sulfamethoxazole	confers no resistance to antibiotic after 18 hours
yneL	Rifampicin	confers no resistance to antibiotic after 18 hours
dkgB	Sulfamethoxazole	confers no resistance to antibiotic after 18 hours
ugd	Vancomycin	confers no resistance to antibiotic after 18 hours
yoeA	Vancomycin	confers no resistance to antibiotic after 18 hours
fliC	Metronidazole	confers no resistance to antibiotic after 18 hours
yccU	Gentamicin	confers no resistance to antibiotic after 18 hours
yedA	Sulfamethoxazole	confers no resistance to antibiotic after 18 hours
gdhA	Gentamicin	confers no resistance to antibiotic after 18 hours
ygaZ	Vancomycin	confers no resistance to antibiotic after 18 hours
aroG	Vancomycin	confers no resistance to antibiotic after 18 hours
ftnB	Ampicillin	confers no resistance to antibiotic after 18 hours
tiaE	Gentamicin	confers no resistance to antibiotic after 18 hours
eutA	Sulfamethoxazole	confers no resistance to antibiotic after 18 hours
nuoH	Rifampicin	confers no resistance to antibiotic after 18 hours
rhaM	Ampicillin	confers no resistance to antibiotic after 18 hours
flgN	Gentamicin	confers no resistance to antibiotic after 18 hours
nfsA	Metronidazole	confers no resistance to antibiotic after 18 hours
ycbX	Ciprofloxacin	confers no resistance to antibiotic after 18 hours
hybD	Vancomycin	confers no resistance to antibiotic after 18 hours
yegK	Gentamicin	confers no resistance to antibiotic after 18 hours
araF	Metronidazole	confers no resistance to antibiotic after 18 hours
sseB	Metronidazole	confers no resistance to antibiotic after 18 hours
potG	Rifampicin	confers no resistance to antibiotic after 18 hours
mglA	Rifampicin	confers no resistance to antibiotic after 18 hours
yigA	Sulfamethoxazole	confers no resistance to antibiotic after 18 hours
yadI	Ampicillin	confers no resistance to antibiotic after 18 hours
yejO	Ampicillin	confers no resistance to antibiotic after 18 hours
blc	Vancomycin	confers no resistance to antibiotic after 18 hours
cof	Vancomycin	confers no resistance to antibiotic after 18 hours
ybjX	Ciprofloxacin	confers no resistance to antibiotic after 18 hours
ygiF	Vancomycin	confers no resistance to antibiotic after 18 hours
ybaS	Metronidazole	confers no resistance to antibiotic after 18 hours
ypdB	Gentamicin	confers no resistance to antibiotic after 18 hours
gltL	Sulfamethoxazole	confers no resistance to antibiotic after 18 hours
ybeU	Vancomycin	confers no resistance to antibiotic after 18 hours
arfB	Ciprofloxacin	confers no resistance to antibiotic after 18 hours
glnA	Vancomycin	confers no resistance to antibiotic after 18 hours
higA	Gentamicin	confers no resistance to antibiotic after 18 hours
rhaS	Metronidazole	confers no resistance to antibiotic after 18 hours
yqaC	Vancomycin	confers no resistance to antibiotic after 18 hours
wcaD	Gentamicin	confers no resistance to antibiotic after 18 hours
zapA	Ampicillin	confers no resistance to antibiotic after 18 hours
ygbJ	Ampicillin	confers no resistance to antibiotic after 18 hours
yhjH	Ampicillin	confers no resistance to antibiotic after 18 hours
glcD	Rifampicin	confers no resistance to antibiotic after 18 hours
trg	Sulfamethoxazole	confers no resistance to antibiotic after 18 hours
yfaW	Metronidazole	confers no resistance to antibiotic after 18 hours
nanS	Gentamicin	confers no resistance to antibiotic after 18 hours
ycbZ	Sulfamethoxazole	confers no resistance to antibiotic after 18 hours
guaA	Rifampicin	confers no resistance to antibiotic after 18 hours
ugpE	Ampicillin	confers no resistance to antibiotic after 18 hours
ypeB	Vancomycin	confers no resistance to antibiotic after 18 hours
ybhA	Sulfamethoxazole	confers no resistance to antibiotic after 18 hours
fhuC	Sulfamethoxazole	confers no resistance to antibiotic after 18 hours
mglA	Sulfamethoxazole	confers no resistance to antibiotic after 18 hours
clpB	Vancomycin	confers no resistance to antibiotic after 18 hours
gspF	Metronidazole	confers no resistance to antibiotic after 18 hours
luxS	Sulfamethoxazole	confers no resistance to antibiotic after 18 hours
queA	Gentamicin	confers no resistance to antibiotic after 18 hours
yraQ	Gentamicin	confers no resistance to antibiotic after 18 hours
ydfG	Metronidazole	confers no resistance to antibiotic after 18 hours
aroM	Ampicillin	confers no resistance to antibiotic after 18 hours
torA	Rifampicin	confers no resistance to antibiotic after 18 hours
yaeB	Sulfamethoxazole	confers no resistance to antibiotic after 18 hours
ydiS	Rifampicin	confers no resistance to antibiotic after 18 hours
yidP	Vancomycin	confers no resistance to antibiotic after 18 hours
arsB	Rifampicin	confers no resistance to antibiotic after 18 hours
yjfN	Gentamicin	confers no resistance to antibiotic after 18 hours
lldD	Vancomycin	confers no resistance to antibiotic after 18 hours
trkA	Ciprofloxacin	confers no resistance to antibiotic after 18 hours
fdoH	Metronidazole	confers no resistance to antibiotic after 18 hours
kduD	Vancomycin	confers no resistance to antibiotic after 18 hours
ybaQ	Sulfamethoxazole	confers no resistance to antibiotic after 18 hours
ygfS	Ampicillin	confers no resistance to antibiotic after 18 hours
soxS	Gentamicin	confers no resistance to antibiotic after 18 hours
osmF	Ciprofloxacin	confers no resistance to antibiotic after 18 hours
yhjE	Gentamicin	confers no resistance to antibiotic after 18 hours
yneL	Ampicillin	confers no resistance to antibiotic after 18 hours
yjbG	Ciprofloxacin	confers no resistance to antibiotic after 18 hours
cpdB	Metronidazole	confers no resistance to antibiotic after 18 hours
yciN	Gentamicin	confers no resistance to antibiotic after 18 hours
ebgC	Vancomycin	confers no resistance to antibiotic after 18 hours
ygcN	Gentamicin	confers no resistance to antibiotic after 18 hours
fepE	Gentamicin	confers no resistance to antibiotic after 18 hours
yagB	Rifampicin	confers no resistance to antibiotic after 18 hours
dam	Rifampicin	confers no resistance to antibiotic after 18 hours
mpl	Ciprofloxacin	confers no resistance to antibiotic after 18 hours
rlmA	Gentamicin	confers no resistance to antibiotic after 18 hours
ydhI	Vancomycin	confers no resistance to antibiotic after 18 hours
yehU	Ampicillin	confers no resistance to antibiotic after 18 hours
mdtI	Ciprofloxacin	confers no resistance to antibiotic after 18 hours
ycaR	Ampicillin	confers no resistance to antibiotic after 18 hours
sohB	Gentamicin	confers no resistance to antibiotic after 18 hours
yicG	Ampicillin	confers no resistance to antibiotic after 18 hours
pdxK	Ciprofloxacin	confers no resistance to antibiotic after 18 hours
fimI	Metronidazole	confers no resistance to antibiotic after 18 hours
ybiP	Gentamicin	confers no resistance to antibiotic after 18 hours
yqiK	Ciprofloxacin	confers no resistance to antibiotic after 18 hours
ysgA	Vancomycin	confers no resistance to antibiotic after 18 hours
leuE	Ciprofloxacin	confers no resistance to antibiotic after 18 hours
atpD	Ampicillin	confers no resistance to antibiotic after 18 hours
ypdB	Sulfamethoxazole	confers no resistance to antibiotic after 18 hours
tfaX	Metronidazole	confers no resistance to antibiotic after 18 hours
elbB	Ampicillin	confers no resistance to antibiotic after 18 hours
yneK	Ciprofloxacin	confers no resistance to antibiotic after 18 hours
bamC	Ampicillin	confers no resistance to antibiotic after 18 hours
purB	Metronidazole	confers no resistance to antibiotic after 18 hours
ynfE	Ampicillin	confers no resistance to antibiotic after 18 hours
livH	Sulfamethoxazole	confers no resistance to antibiotic after 18 hours
yhhY	Ciprofloxacin	confers no resistance to antibiotic after 18 hours
yneG	Vancomycin	confers no resistance to antibiotic after 18 hours
uvrA	Metronidazole	confers resistance to antibiotic after 18 hours
yeiE	Vancomycin	confers no resistance to antibiotic after 18 hours
yfjT	Sulfamethoxazole	confers no resistance to antibiotic after 18 hours
gadB	Vancomycin	confers no resistance to antibiotic after 18 hours
yicL	Sulfamethoxazole	confers no resistance to antibiotic after 18 hours
yedF	Rifampicin	confers no resistance to antibiotic after 18 hours
nikA	Metronidazole	confers no resistance to antibiotic after 18 hours
trmA	Ciprofloxacin	confers no resistance to antibiotic after 18 hours
hypT	Ciprofloxacin	confers no resistance to antibiotic after 18 hours
panD	Gentamicin	confers no resistance to antibiotic after 18 hours
yaeF	Rifampicin	confers no resistance to antibiotic after 18 hours
aphA	Gentamicin	confers no resistance to antibiotic after 18 hours
cybB	Gentamicin	confers no resistance to antibiotic after 18 hours
araG	Ampicillin	confers no resistance to antibiotic after 18 hours
abgT	Gentamicin	confers no resistance to antibiotic after 18 hours
ycdX	Rifampicin	confers no resistance to antibiotic after 18 hours
yqhC	Metronidazole	confers no resistance to antibiotic after 18 hours
yhjV	Ampicillin	confers no resistance to antibiotic after 18 hours
intE	Rifampicin	confers no resistance to antibiotic after 18 hours
loiP	Vancomycin	confers no resistance to antibiotic after 18 hours
livG	Sulfamethoxazole	confers no resistance to antibiotic after 18 hours
gapC	Ciprofloxacin	confers no resistance to antibiotic after 18 hours
yjiP	Vancomycin	confers no resistance to antibiotic after 18 hours
yojI	Rifampicin	confers no resistance to antibiotic after 18 hours
mhpF	Ciprofloxacin	confers no resistance to antibiotic after 18 hours
xapB	Vancomycin	confers no resistance to antibiotic after 18 hours
add	Ampicillin	confers no resistance to antibiotic after 18 hours
yhbW	Ampicillin	confers no resistance to antibiotic after 18 hours
nuoG	Ampicillin	confers no resistance to antibiotic after 18 hours
gpmM	Vancomycin	confers no resistance to antibiotic after 18 hours
glnP	Rifampicin	confers no resistance to antibiotic after 18 hours
mutL	Vancomycin	confers no resistance to antibiotic after 18 hours
none	Sulfamethoxazole	confers no resistance to antibiotic after 18 hours
cheB	Sulfamethoxazole	confers no resistance to antibiotic after 18 hours
arnA	Metronidazole	confers no resistance to antibiotic after 18 hours
kdpA	Ciprofloxacin	confers no resistance to antibiotic after 18 hours
artQ	Ciprofloxacin	confers no resistance to antibiotic after 18 hours
malY	Ampicillin	confers no resistance to antibiotic after 18 hours
yciV	Gentamicin	confers no resistance to antibiotic after 18 hours
yceF	Rifampicin	confers no resistance to antibiotic after 18 hours
yifN	Metronidazole	confers no resistance to antibiotic after 18 hours
yjbM	Sulfamethoxazole	confers no resistance to antibiotic after 18 hours
soxS	Sulfamethoxazole	confers no resistance to antibiotic after 18 hours
artM	Ciprofloxacin	confers no resistance to antibiotic after 18 hours
gmm	Metronidazole	confers no resistance to antibiotic after 18 hours
ybfE	Ciprofloxacin	confers no resistance to antibiotic after 18 hours
guaD	Ciprofloxacin	confers no resistance to antibiotic after 18 hours
yeaX	Gentamicin	confers no resistance to antibiotic after 18 hours
phnD	Ampicillin	confers no resistance to antibiotic after 18 hours
yiaU	Sulfamethoxazole	confers no resistance to antibiotic after 18 hours
dppD	Rifampicin	confers no resistance to antibiotic after 18 hours
tfaQ	Ampicillin	confers no resistance to antibiotic after 18 hours
yfcG	Metronidazole	confers no resistance to antibiotic after 18 hours
abgR	Vancomycin	confers no resistance to antibiotic after 18 hours
ydaE	Rifampicin	confers no resistance to antibiotic after 18 hours
ygiM	Sulfamethoxazole	confers no resistance to antibiotic after 18 hours
yeeL	Vancomycin	confers no resistance to antibiotic after 18 hours
yghE	Vancomycin	confers no resistance to antibiotic after 18 hours
relB	Ampicillin	confers no resistance to antibiotic after 18 hours
ydjI	Sulfamethoxazole	confers resistance to antibiotic after 18 hours
pepP	Metronidazole	confers no resistance to antibiotic after 18 hours
glpQ	Metronidazole	confers no resistance to antibiotic after 18 hours
ykgM	Metronidazole	confers no resistance to antibiotic after 18 hours
yaaU	Ampicillin	confers no resistance to antibiotic after 18 hours
nikD	Gentamicin	confers no resistance to antibiotic after 18 hours
pheL	Gentamicin	confers no resistance to antibiotic after 18 hours
yciO	Gentamicin	confers no resistance to antibiotic after 18 hours
yghQ	Rifampicin	confers no resistance to antibiotic after 18 hours
dhaL	Ciprofloxacin	confers no resistance to antibiotic after 18 hours
yhiJ	Ciprofloxacin	confers no resistance to antibiotic after 18 hours
gfcD	Ciprofloxacin	confers no resistance to antibiotic after 18 hours
cysK	Rifampicin	confers no resistance to antibiotic after 18 hours
frwC	Ampicillin	confers no resistance to antibiotic after 18 hours
yegH	Rifampicin	confers no resistance to antibiotic after 18 hours
rhaR	Vancomycin	confers no resistance to antibiotic after 18 hours
ribD	Ampicillin	confers no resistance to antibiotic after 18 hours
yedV	Ciprofloxacin	confers no resistance to antibiotic after 18 hours
tolR	Sulfamethoxazole	confers no resistance to antibiotic after 18 hours
ymgH	Gentamicin	confers no resistance to antibiotic after 18 hours
rstB	Vancomycin	confers no resistance to antibiotic after 18 hours
sgcX	Ampicillin	confers no resistance to antibiotic after 18 hours
zapA	Vancomycin	confers no resistance to antibiotic after 18 hours
fabH	Ciprofloxacin	confers no resistance to antibiotic after 18 hours
yjiP	Metronidazole	confers no resistance to antibiotic after 18 hours
ompG	Vancomycin	confers no resistance to antibiotic after 18 hours
lysC	Vancomycin	confers no resistance to antibiotic after 18 hours
thiP	Sulfamethoxazole	confers no resistance to antibiotic after 18 hours
yafW	Ampicillin	confers no resistance to antibiotic after 18 hours
yegP	Ciprofloxacin	confers no resistance to antibiotic after 18 hours
yjhR	Ampicillin	confers no resistance to antibiotic after 18 hours
cadB	Metronidazole	confers no resistance to antibiotic after 18 hours
gadB	Gentamicin	confers no resistance to antibiotic after 18 hours
potI	Gentamicin	confers no resistance to antibiotic after 18 hours
pgaB	Metronidazole	confers no resistance to antibiotic after 18 hours
yjiS	Gentamicin	confers no resistance to antibiotic after 18 hours
yiaA	Ciprofloxacin	confers no resistance to antibiotic after 18 hours
mlaF	Rifampicin	confers no resistance to antibiotic after 18 hours
mcrC	Rifampicin	confers no resistance to antibiotic after 18 hours
yibT	Ciprofloxacin	confers no resistance to antibiotic after 18 hours
rmf	Gentamicin	confers no resistance to antibiotic after 18 hours
ydgC	Vancomycin	confers no resistance to antibiotic after 18 hours
yrdD	Sulfamethoxazole	confers no resistance to antibiotic after 18 hours
ypjM_2	Rifampicin	confers no resistance to antibiotic after 18 hours
galF	Vancomycin	confers no resistance to antibiotic after 18 hours
yegJ	Rifampicin	confers no resistance to antibiotic after 18 hours
ycbB	Vancomycin	confers no resistance to antibiotic after 18 hours
yicR	Ciprofloxacin	confers no resistance to antibiotic after 18 hours
gutQ	Rifampicin	confers no resistance to antibiotic after 18 hours
ompW	Metronidazole	confers no resistance to antibiotic after 18 hours
yfcR	Ampicillin	confers no resistance to antibiotic after 18 hours
artP	Gentamicin	confers no resistance to antibiotic after 18 hours
yeeO	Rifampicin	confers no resistance to antibiotic after 18 hours
rsxA	Metronidazole	confers no resistance to antibiotic after 18 hours
ybbN	Sulfamethoxazole	confers no resistance to antibiotic after 18 hours
yiaY	Gentamicin	confers no resistance to antibiotic after 18 hours
ydhC	Metronidazole	confers no resistance to antibiotic after 18 hours
tpiA	Ciprofloxacin	confers no resistance to antibiotic after 18 hours
ypfG	Rifampicin	confers no resistance to antibiotic after 18 hours
tfaQ	Sulfamethoxazole	confers no resistance to antibiotic after 18 hours
flgI	Sulfamethoxazole	confers no resistance to antibiotic after 18 hours
hinT	Gentamicin	confers no resistance to antibiotic after 18 hours
yqeH	Gentamicin	confers no resistance to antibiotic after 18 hours
ymdA	Ampicillin	confers no resistance to antibiotic after 18 hours
yegJ	Gentamicin	confers no resistance to antibiotic after 18 hours
ygeX	Sulfamethoxazole	confers no resistance to antibiotic after 18 hours
nac	Rifampicin	confers no resistance to antibiotic after 18 hours
cbpM	Rifampicin	confers no resistance to antibiotic after 18 hours
yfdC	Sulfamethoxazole	confers no resistance to antibiotic after 18 hours
yiaV	Ciprofloxacin	confers no resistance to antibiotic after 18 hours
rplI	Ciprofloxacin	confers no resistance to antibiotic after 18 hours
malG	Metronidazole	confers no resistance to antibiotic after 18 hours
priA	Metronidazole	confers no resistance to antibiotic after 18 hours
fliJ	Vancomycin	confers no resistance to antibiotic after 18 hours
argT	Gentamicin	confers no resistance to antibiotic after 18 hours
crcB	Ciprofloxacin	confers no resistance to antibiotic after 18 hours
hflK	Rifampicin	confers no resistance to antibiotic after 18 hours
dgt	Ampicillin	confers no resistance to antibiotic after 18 hours
elfC	Vancomycin	confers no resistance to antibiotic after 18 hours
yihO	Ciprofloxacin	confers no resistance to antibiotic after 18 hours
rffD	Ciprofloxacin	confers no resistance to antibiotic after 18 hours
hcp	Vancomycin	confers no resistance to antibiotic after 18 hours
purH	Metronidazole	confers no resistance to antibiotic after 18 hours
mioC	Ampicillin	confers no resistance to antibiotic after 18 hours
ivbL	Vancomycin	confers no resistance to antibiotic after 18 hours
lysS	Vancomycin	confers no resistance to antibiotic after 18 hours
hpt	Sulfamethoxazole	confers no resistance to antibiotic after 18 hours
avtA	Rifampicin	confers no resistance to antibiotic after 18 hours
fieF	Gentamicin	confers no resistance to antibiotic after 18 hours
yjgN	Metronidazole	confers no resistance to antibiotic after 18 hours
kdpB	Vancomycin	confers no resistance to antibiotic after 18 hours
ptsH	Ciprofloxacin	confers no resistance to antibiotic after 18 hours
ygiQ	Gentamicin	confers no resistance to antibiotic after 18 hours
elfD	Sulfamethoxazole	confers no resistance to antibiotic after 18 hours
cas1	Ampicillin	confers no resistance to antibiotic after 18 hours
ybiA	Vancomycin	confers no resistance to antibiotic after 18 hours
yagJ	Vancomycin	confers no resistance to antibiotic after 18 hours
yigA	Gentamicin	confers no resistance to antibiotic after 18 hours
yiaL	Rifampicin	confers no resistance to antibiotic after 18 hours
kptA	Rifampicin	confers no resistance to antibiotic after 18 hours
yqjD	Rifampicin	confers no resistance to antibiotic after 18 hours
aceE	Ampicillin	confers no resistance to antibiotic after 18 hours
ydfX	Sulfamethoxazole	confers no resistance to antibiotic after 18 hours
ydhL	Gentamicin	confers no resistance to antibiotic after 18 hours
yfjU	Metronidazole	confers no resistance to antibiotic after 18 hours
atoD	Gentamicin	confers no resistance to antibiotic after 18 hours
dnaK	Rifampicin	confers resistance to antibiotic after 18 hours
dadX	Gentamicin	confers no resistance to antibiotic after 18 hours
lldD	Rifampicin	confers no resistance to antibiotic after 18 hours
ydgC	Rifampicin	confers no resistance to antibiotic after 18 hours
yhhT	Sulfamethoxazole	confers no resistance to antibiotic after 18 hours
ycfD	Ampicillin	confers no resistance to antibiotic after 18 hours
ravA	Vancomycin	confers no resistance to antibiotic after 18 hours
nagB	Gentamicin	confers no resistance to antibiotic after 18 hours
dinD	Ciprofloxacin	confers no resistance to antibiotic after 18 hours
ymfQ	Metronidazole	confers no resistance to antibiotic after 18 hours
fliI	Ciprofloxacin	confers no resistance to antibiotic after 18 hours
alsB	Rifampicin	confers no resistance to antibiotic after 18 hours
nuoE	Sulfamethoxazole	confers no resistance to antibiotic after 18 hours
bdm	Ciprofloxacin	confers no resistance to antibiotic after 18 hours
ytfT	Rifampicin	confers no resistance to antibiotic after 18 hours
torR	Gentamicin	confers no resistance to antibiotic after 18 hours
hyaE	Sulfamethoxazole	confers no resistance to antibiotic after 18 hours
fliD	Gentamicin	confers no resistance to antibiotic after 18 hours
chiA	Metronidazole	confers no resistance to antibiotic after 18 hours
ahr	Ciprofloxacin	confers no resistance to antibiotic after 18 hours
crl	Rifampicin	confers no resistance to antibiotic after 18 hours
ybiP	Ampicillin	confers no resistance to antibiotic after 18 hours
marR	Ciprofloxacin	confers no resistance to antibiotic after 18 hours
yjiV	Metronidazole	confers no resistance to antibiotic after 18 hours
aroA	Sulfamethoxazole	confers no resistance to antibiotic after 18 hours
lacA	Sulfamethoxazole	confers no resistance to antibiotic after 18 hours
avtA	Ampicillin	confers no resistance to antibiotic after 18 hours
hscB	Metronidazole	confers no resistance to antibiotic after 18 hours
xdhD	Ciprofloxacin	confers no resistance to antibiotic after 18 hours
glnL	Ampicillin	confers no resistance to antibiotic after 18 hours
ydeP	Ciprofloxacin	confers no resistance to antibiotic after 18 hours
sulA	Sulfamethoxazole	confers no resistance to antibiotic after 18 hours
glvB	Vancomycin	confers no resistance to antibiotic after 18 hours
eutJ	Ampicillin	confers no resistance to antibiotic after 18 hours
ykgN	Vancomycin	confers no resistance to antibiotic after 18 hours
phoU	Ciprofloxacin	confers no resistance to antibiotic after 18 hours
yhfX	Metronidazole	confers no resistance to antibiotic after 18 hours
norR	Vancomycin	confers no resistance to antibiotic after 18 hours
yfgF	Metronidazole	confers no resistance to antibiotic after 18 hours
hydN	Vancomycin	confers no resistance to antibiotic after 18 hours
ydeO	Rifampicin	confers no resistance to antibiotic after 18 hours
psuT	Sulfamethoxazole	confers no resistance to antibiotic after 18 hours
ygaZ	Sulfamethoxazole	confers no resistance to antibiotic after 18 hours
narH	Metronidazole	confers no resistance to antibiotic after 18 hours
fecI	Ciprofloxacin	confers no resistance to antibiotic after 18 hours
yggP	Ciprofloxacin	confers no resistance to antibiotic after 18 hours
yoaG	Ciprofloxacin	confers no resistance to antibiotic after 18 hours
fsaA	Ciprofloxacin	confers no resistance to antibiotic after 18 hours
bfr	Vancomycin	confers no resistance to antibiotic after 18 hours
envZ	Rifampicin	confers resistance to antibiotic after 18 hours
mutH	Sulfamethoxazole	confers no resistance to antibiotic after 18 hours
yfdQ	Gentamicin	confers no resistance to antibiotic after 18 hours
ulaD	Metronidazole	confers no resistance to antibiotic after 18 hours
yhhX	Metronidazole	confers no resistance to antibiotic after 18 hours
hisP	Ampicillin	confers no resistance to antibiotic after 18 hours
exbB	Rifampicin	confers no resistance to antibiotic after 18 hours
ynfK	Vancomycin	confers no resistance to antibiotic after 18 hours
sgcE	Metronidazole	confers no resistance to antibiotic after 18 hours
rhaS	Ciprofloxacin	confers no resistance to antibiotic after 18 hours
ddpD	Sulfamethoxazole	confers no resistance to antibiotic after 18 hours
slyX	Ampicillin	confers no resistance to antibiotic after 18 hours
lipA	Gentamicin	confers no resistance to antibiotic after 18 hours
glyA	Sulfamethoxazole	confers no resistance to antibiotic after 18 hours
yphG	Metronidazole	confers no resistance to antibiotic after 18 hours
recE	Rifampicin	confers no resistance to antibiotic after 18 hours
yicH	Gentamicin	confers no resistance to antibiotic after 18 hours
pqqL	Vancomycin	confers no resistance to antibiotic after 18 hours
ydjA	Ampicillin	confers no resistance to antibiotic after 18 hours
yfdN	Rifampicin	confers no resistance to antibiotic after 18 hours
clpA	Vancomycin	confers no resistance to antibiotic after 18 hours
yadK	Ciprofloxacin	confers no resistance to antibiotic after 18 hours
yhfK	Rifampicin	confers no resistance to antibiotic after 18 hours
dgcZ	Ciprofloxacin	confers no resistance to antibiotic after 18 hours
yagY	Ciprofloxacin	confers no resistance to antibiotic after 18 hours
phoH	Rifampicin	confers no resistance to antibiotic after 18 hours
ymjA	Gentamicin	confers no resistance to antibiotic after 18 hours
aroH	Metronidazole	confers no resistance to antibiotic after 18 hours
nrdE	Gentamicin	confers no resistance to antibiotic after 18 hours
yiiQ	Sulfamethoxazole	confers no resistance to antibiotic after 18 hours
iscA	Vancomycin	confers no resistance to antibiotic after 18 hours
frmR	Gentamicin	confers no resistance to antibiotic after 18 hours
pgaC	Gentamicin	confers no resistance to antibiotic after 18 hours
hisF	Gentamicin	confers no resistance to antibiotic after 18 hours
yjeT	Ampicillin	confers no resistance to antibiotic after 18 hours
wbbL	Ciprofloxacin	confers no resistance to antibiotic after 18 hours
mppA	Ampicillin	confers no resistance to antibiotic after 18 hours
chbA	Ciprofloxacin	confers no resistance to antibiotic after 18 hours
yfcV	Vancomycin	confers no resistance to antibiotic after 18 hours
fdnH	Rifampicin	confers no resistance to antibiotic after 18 hours
ugd	Metronidazole	confers no resistance to antibiotic after 18 hours
dtd	Metronidazole	confers no resistance to antibiotic after 18 hours
acrR	Metronidazole	confers no resistance to antibiotic after 18 hours
yhfZ	Ciprofloxacin	confers no resistance to antibiotic after 18 hours
ybjT	Ciprofloxacin	confers no resistance to antibiotic after 18 hours
fliE	Rifampicin	confers no resistance to antibiotic after 18 hours
napA	Ciprofloxacin	confers no resistance to antibiotic after 18 hours
agaI	Ciprofloxacin	confers no resistance to antibiotic after 18 hours
tamA	Sulfamethoxazole	confers no resistance to antibiotic after 18 hours
ybhJ	Rifampicin	confers no resistance to antibiotic after 18 hours
modB	Ciprofloxacin	confers no resistance to antibiotic after 18 hours
yjjY	Rifampicin	confers resistance to antibiotic after 18 hours
hybE	Rifampicin	confers no resistance to antibiotic after 18 hours
yibT	Ampicillin	confers no resistance to antibiotic after 18 hours
queG	Sulfamethoxazole	confers no resistance to antibiotic after 18 hours
nudB	Gentamicin	confers no resistance to antibiotic after 18 hours
tyrB	Ampicillin	confers no resistance to antibiotic after 18 hours
ydhK	Metronidazole	confers no resistance to antibiotic after 18 hours
pspA	Gentamicin	confers no resistance to antibiotic after 18 hours
yedY	Metronidazole	confers no resistance to antibiotic after 18 hours
yebG	Metronidazole	confers no resistance to antibiotic after 18 hours
paaY	Ampicillin	confers no resistance to antibiotic after 18 hours
yadV	Gentamicin	confers no resistance to antibiotic after 18 hours
ydcD	Ciprofloxacin	confers no resistance to antibiotic after 18 hours
yobH	Rifampicin	confers no resistance to antibiotic after 18 hours
acpH	Ampicillin	confers no resistance to antibiotic after 18 hours
yncG	Sulfamethoxazole	confers no resistance to antibiotic after 18 hours
aspA	Gentamicin	confers no resistance to antibiotic after 18 hours
yjgH	Vancomycin	confers no resistance to antibiotic after 18 hours
yciS	Ampicillin	confers no resistance to antibiotic after 18 hours
yagW	Vancomycin	confers no resistance to antibiotic after 18 hours
yecH	Metronidazole	confers no resistance to antibiotic after 18 hours
yciM	Sulfamethoxazole	confers resistance to antibiotic after 18 hours
serB	Ciprofloxacin	confers no resistance to antibiotic after 18 hours
glpG	Sulfamethoxazole	confers no resistance to antibiotic after 18 hours
yhgF	Vancomycin	confers no resistance to antibiotic after 18 hours
yebK	Ampicillin	confers no resistance to antibiotic after 18 hours
eutN	Gentamicin	confers no resistance to antibiotic after 18 hours
rob	Ciprofloxacin	confers no resistance to antibiotic after 18 hours
mmuM	Ciprofloxacin	confers no resistance to antibiotic after 18 hours
metR	Gentamicin	confers no resistance to antibiotic after 18 hours
ycaD	Sulfamethoxazole	confers no resistance to antibiotic after 18 hours
leuE	Sulfamethoxazole	confers no resistance to antibiotic after 18 hours
nikE	Ampicillin	confers no resistance to antibiotic after 18 hours
tyrP	Vancomycin	confers no resistance to antibiotic after 18 hours
hcr	Ampicillin	confers no resistance to antibiotic after 18 hours
gltS	Gentamicin	confers no resistance to antibiotic after 18 hours
yciN	Sulfamethoxazole	confers no resistance to antibiotic after 18 hours
sseB	Gentamicin	confers no resistance to antibiotic after 18 hours
yedL	Sulfamethoxazole	confers no resistance to antibiotic after 18 hours
add	Vancomycin	confers no resistance to antibiotic after 18 hours
entB	Ciprofloxacin	confers no resistance to antibiotic after 18 hours
betI	Vancomycin	confers no resistance to antibiotic after 18 hours
exoX	Ciprofloxacin	confers no resistance to antibiotic after 18 hours
ybhK	Ciprofloxacin	confers no resistance to antibiotic after 18 hours
yjhD	Metronidazole	confers no resistance to antibiotic after 18 hours
yraP	Sulfamethoxazole	confers no resistance to antibiotic after 18 hours
xylE	Ampicillin	confers no resistance to antibiotic after 18 hours
mdoH	Sulfamethoxazole	confers no resistance to antibiotic after 18 hours
pagB	Gentamicin	confers no resistance to antibiotic after 18 hours
nfsA	Sulfamethoxazole	confers no resistance to antibiotic after 18 hours
yfaA	Metronidazole	confers no resistance to antibiotic after 18 hours
icdC	Gentamicin	confers no resistance to antibiotic after 18 hours
fimB	Vancomycin	confers no resistance to antibiotic after 18 hours
yoaB	Rifampicin	confers no resistance to antibiotic after 18 hours
ydeT	Rifampicin	confers no resistance to antibiotic after 18 hours
ykfG	Ciprofloxacin	confers no resistance to antibiotic after 18 hours
metB	Gentamicin	confers no resistance to antibiotic after 18 hours
yihO	Gentamicin	confers no resistance to antibiotic after 18 hours
agaC	Metronidazole	confers no resistance to antibiotic after 18 hours
slyB	Vancomycin	confers no resistance to antibiotic after 18 hours
fucI	Vancomycin	confers no resistance to antibiotic after 18 hours
higA	Metronidazole	confers no resistance to antibiotic after 18 hours
yqfE	Vancomycin	confers no resistance to antibiotic after 18 hours
dgoA	Ciprofloxacin	confers no resistance to antibiotic after 18 hours
yhjX	Rifampicin	confers no resistance to antibiotic after 18 hours
ccmA	Sulfamethoxazole	confers no resistance to antibiotic after 18 hours
trxA	Sulfamethoxazole	confers no resistance to antibiotic after 18 hours
yqiB	Metronidazole	confers no resistance to antibiotic after 18 hours
tomB	Ciprofloxacin	confers no resistance to antibiotic after 18 hours
hyfD	Gentamicin	confers no resistance to antibiotic after 18 hours
yciV	Vancomycin	confers no resistance to antibiotic after 18 hours
ldcC	Metronidazole	confers no resistance to antibiotic after 18 hours
hisG	Gentamicin	confers no resistance to antibiotic after 18 hours
yobA	Ciprofloxacin	confers no resistance to antibiotic after 18 hours
yjfN	Vancomycin	confers no resistance to antibiotic after 18 hours
yfcQ	Sulfamethoxazole	confers no resistance to antibiotic after 18 hours
lar	Rifampicin	confers no resistance to antibiotic after 18 hours
abgT	Rifampicin	confers no resistance to antibiotic after 18 hours
dinD	Metronidazole	confers no resistance to antibiotic after 18 hours
panE	Metronidazole	confers no resistance to antibiotic after 18 hours
arnC	Sulfamethoxazole	confers no resistance to antibiotic after 18 hours
ssuE	Vancomycin	confers no resistance to antibiotic after 18 hours
hsdM	Ampicillin	confers no resistance to antibiotic after 18 hours
ybbB	Metronidazole	confers no resistance to antibiotic after 18 hours
mtlD	Sulfamethoxazole	confers no resistance to antibiotic after 18 hours
exbB	Ampicillin	confers no resistance to antibiotic after 18 hours
fepC	Ampicillin	confers no resistance to antibiotic after 18 hours
hisQ	Ciprofloxacin	confers no resistance to antibiotic after 18 hours
yafP	Metronidazole	confers no resistance to antibiotic after 18 hours
tehB	Ampicillin	confers no resistance to antibiotic after 18 hours
yraQ	Vancomycin	confers no resistance to antibiotic after 18 hours
pinE	Rifampicin	confers no resistance to antibiotic after 18 hours
ypdF	Gentamicin	confers no resistance to antibiotic after 18 hours
paoB	Rifampicin	confers no resistance to antibiotic after 18 hours
ybaN	Ciprofloxacin	confers no resistance to antibiotic after 18 hours
flgJ	Ampicillin	confers no resistance to antibiotic after 18 hours
yhfU	Gentamicin	confers no resistance to antibiotic after 18 hours
yeeO	Ciprofloxacin	confers no resistance to antibiotic after 18 hours
uspC	Metronidazole	confers no resistance to antibiotic after 18 hours
ybdH	Rifampicin	confers no resistance to antibiotic after 18 hours
ydjE	Vancomycin	confers no resistance to antibiotic after 18 hours
yjdM	Sulfamethoxazole	confers no resistance to antibiotic after 18 hours
flgG	Metronidazole	confers no resistance to antibiotic after 18 hours
ybcN	Gentamicin	confers no resistance to antibiotic after 18 hours
hyaE	Rifampicin	confers no resistance to antibiotic after 18 hours
yedF	Ampicillin	confers no resistance to antibiotic after 18 hours
yqiG	Ciprofloxacin	confers no resistance to antibiotic after 18 hours
yjbE	Gentamicin	confers no resistance to antibiotic after 18 hours
asnA	Vancomycin	confers no resistance to antibiotic after 18 hours
iscS	Ampicillin	confers no resistance to antibiotic after 18 hours
yciQ	Rifampicin	confers no resistance to antibiotic after 18 hours
yeaR	Gentamicin	confers no resistance to antibiotic after 18 hours
yciQ	Ciprofloxacin	confers no resistance to antibiotic after 18 hours
mntR	Rifampicin	confers no resistance to antibiotic after 18 hours
dtd	Ampicillin	confers no resistance to antibiotic after 18 hours
yheS	Ciprofloxacin	confers no resistance to antibiotic after 18 hours
nikE	Vancomycin	confers no resistance to antibiotic after 18 hours
trmL	Ciprofloxacin	confers no resistance to antibiotic after 18 hours
relA	Ampicillin	confers no resistance to antibiotic after 18 hours
yfjI	Vancomycin	confers no resistance to antibiotic after 18 hours
xylG	Ciprofloxacin	confers no resistance to antibiotic after 18 hours
fdhE	Metronidazole	confers no resistance to antibiotic after 18 hours
ugpC	Ampicillin	confers no resistance to antibiotic after 18 hours
ymfN	Metronidazole	confers no resistance to antibiotic after 18 hours
sodA	Sulfamethoxazole	confers no resistance to antibiotic after 18 hours
purH	Ciprofloxacin	confers no resistance to antibiotic after 18 hours
yraP	Metronidazole	confers no resistance to antibiotic after 18 hours
yigF	Gentamicin	confers no resistance to antibiotic after 18 hours
hybA	Sulfamethoxazole	confers no resistance to antibiotic after 18 hours
cspB	Ciprofloxacin	confers no resistance to antibiotic after 18 hours
mtlR	Vancomycin	confers no resistance to antibiotic after 18 hours
ruvB	Vancomycin	confers no resistance to antibiotic after 18 hours
cspE	Rifampicin	confers no resistance to antibiotic after 18 hours
